name,identifier,total,total_esta,total_otra,total_fuera,mujer,mujer_esta,mujer_otra,mujer_fuera,hombre,hombre_esta,hombre_otra,hombre_fuera,total_esta_p,total_otra_p,total_fuera_p,mujer_esta_p,mujer_otra_p,mujer_fuera_p,hombre_esta_p,hombre_otra_p,hombre_fuera_p
Buenos Aires,partido Adolfo Alsina,17344,15376,1795,173,8710,7674,929,107,8634,7702,866,66,0.8865313653136532,0.1034940036900369,0.009974630996309963,0.8810562571756602,0.10665901262916189,0.012284730195177956,0.892054667593236,0.10030113504748668,0.007644197359277276
Buenos Aires,partido Adolfo Gonzales Chaves,12847,12111,642,94,6566,6198,311,57,6281,5913,331,37,0.9427103603954231,0.049972756285514126,0.007316883319062816,0.9439537008833384,0.047365214742613466,0.008681084374048126,0.9414106034071008,0.05269861487024359,0.005890781722655628
Buenos Aires,partido Alberti,12906,11473,1159,274,6651,5882,611,158,6255,5591,548,116,0.8889663722299705,0.08980319231365257,0.02123043545637688,0.8843782889791009,0.09186588482934897,0.023755826191550145,0.8938449240607514,0.08760991207034373,0.018545163868904875
Buenos Aires,partido Almirante Brown,583209,464993,89522,28694,301570,236767,48691,16112,281639,228226,40831,12582,0.7973007961125429,0.15349900293033886,0.04920020095711829,0.7851145670988493,0.1614583678747886,0.05342706502636204,0.810349418937008,0.144976370460057,0.044674210602934965
Buenos Aires,partido Arrecifes,32077,28281,3453,343,16637,14657,1783,197,15440,13624,1670,146,0.8816597562116159,0.10764722386756866,0.010693019920815538,0.8809881589228827,0.10717076395984854,0.011841077117268738,0.8823834196891192,0.10816062176165803,0.009455958549222798
Buenos Aires,partido Avellaneda,366117,272144,67348,26625,193116,141518,36186,15412,173001,130626,31162,11213,0.7433252211724667,0.18395212459405053,0.07272265423348274,0.7328134385550653,0.18737960603989312,0.07980695540504153,0.755059219310871,0.1801261264385755,0.06481465425055347
Buenos Aires,partido Ayacucho,21757,20511,1058,188,11111,10441,553,117,10646,10070,505,71,0.9427310750563037,0.04862802776118031,0.008640897182515973,0.93969939699397,0.04977049770497705,0.01053010530105301,0.9458951718955476,0.047435656584632724,0.006669171519819651
Buenos Aires,partido Azul,75152,67416,6096,1640,38902,34852,3158,892,36250,32564,2938,748,0.8970619544390036,0.08111560570576964,0.02182243985522674,0.8958922420441109,0.08117834558634518,0.022929412369543982,0.8983172413793103,0.08104827586206896,0.02063448275862069
Buenos Aires,partido Bahía Blanca,334505,279012,42048,13445,174321,144029,22755,7537,160184,134983,19293,5908,0.8341041240041255,0.1257021569184317,0.04019371907744279,0.8262286242047716,0.13053504741253205,0.04323632838269629,0.8426746741247565,0.12044274084802477,0.036882585027218695
Buenos Aires,partido Balcarce,48516,43099,4418,999,24921,22171,2199,551,23595,20928,2219,448,0.88834611262264,0.09106274218814411,0.02059114518921593,0.8896512981020023,0.08823883471770795,0.022109867180289716,0.8869675778766688,0.09404534859080313,0.018987073532528077
Buenos Aires,partido Baradero,39223,32944,5347,932,20105,16866,2763,476,19118,16078,2584,456,0.8399153557861458,0.1363230757463733,0.023761568467480815,0.8388957970654066,0.13742850037304152,0.023675702561551853,0.8409875509990585,0.1351605816508003,0.023851867350141227
Buenos Aires,partido Benito Juárez,21185,19366,1434,385,10806,9863,733,210,10379,9503,701,175,0.9141373613405711,0.0676894028793958,0.01817323578003304,0.9127336664815843,0.06783268554506755,0.01943364797334814,0.9155988052798921,0.06754022545524617,0.01686096926486174
Buenos Aires,partido Berazategui,358328,291566,51662,15100,185198,148278,28273,8647,173130,143288,23389,6453,0.8136846687950704,0.1441751691187962,0.04214016208613337,0.8006457953109645,0.1526636356764112,0.046690569012624326,0.8276324149483048,0.13509501530641715,0.037272569745278115
Buenos Aires,partido Berisso,100685,83735,10558,6392,52340,43054,5820,3466,48345,40681,4738,2926,0.831653175746139,0.10486169737299499,0.06348512688086606,0.8225831104317921,0.11119602598395109,0.06622086358425679,0.8414727479573896,0.09800393008584135,0.06052332195676906
Buenos Aires,partido Bolívar,37194,34395,2217,582,19288,17847,1113,328,17906,16548,1104,254,0.924745926762381,0.05960638812711728,0.015647685110501693,0.9252903359601825,0.057704272086271255,0.017005391953546247,0.9241594996090696,0.06165531106891545,0.014185189322014968
Buenos Aires,partido Bragado,46227,41749,3444,1034,23826,21493,1780,553,22401,20256,1664,481,0.90313020529128,0.07450191446557207,0.022367880243147942,0.9020817594224796,0.07470830185511626,0.023209938722404098,0.9042453461899023,0.07428239810722735,0.021472255702870407
Buenos Aires,partido Brandsen,32350,28539,3016,795,16549,14577,1521,451,15801,13962,1495,344,0.882194744976816,0.09323029366306028,0.02457496136012365,0.8808387213728927,0.09190887666928516,0.027252401957822223,0.8836149610784128,0.09461426491994178,0.021770774001645465
Buenos Aires,partido Campana,107976,86600,17639,3737,55066,43959,9149,1958,52910,42641,8490,1779,0.8020300807586871,0.16336037637993628,0.0346095428613766,0.7982965895470889,0.16614607925035413,0.035557331202556934,0.8059157059157059,0.16046116046116046,0.03362313362313362
Buenos Aires,partido Cañuelas,70542,57848,9372,3322,35909,29470,4715,1724,34633,28378,4657,1598,0.820050466388818,0.13285702134898358,0.047092512262198405,0.8206856219889165,0.13130412988387313,0.04801024812721045,0.8193919094505241,0.13446712672884242,0.0461409638206335
Buenos Aires,partido Capitán Sarmiento,15882,13331,2303,248,8206,6873,1196,137,7676,6458,1107,111,0.8393779121017504,0.1450069260798388,0.015615161818410779,0.8375578844747745,0.14574701437972215,0.01669510114550329,0.841323606044815,0.14421573736321,0.014460656591974987
Buenos Aires,partido Carlos Casares,22905,21229,1419,257,11754,10930,687,137,11151,10299,732,120,0.9268282034490286,0.061951538965291424,0.011220257585679983,0.9298962055470478,0.05844818785094436,0.011655606602007828,0.9235942964756524,0.06564433683077751,0.010761366693570083
Buenos Aires,partido Carlos Tejedor,14007,11057,2411,539,7041,5556,1212,273,6966,5501,1199,266,0.7893910187763261,0.17212822160348398,0.0384807596201899,0.7890924584576055,0.17213463996591394,0.03877290157648061,0.7896927935687625,0.17212173413723802,0.03818547229399943
Buenos Aires,partido Carmen de Areco,17345,15288,1822,235,8731,7706,902,123,8614,7582,920,112,0.8814067454597867,0.10504468146439896,0.013548573075814356,0.8826022219677013,0.10331004466842286,0.014087733363875844,0.8801950313443232,0.10680287903413048,0.01300208962154632
Buenos Aires,partido Castelli,9551,8619,789,143,4862,4394,403,65,4689,4225,386,78,0.9024185949115275,0.08260915087425401,0.014972254214218406,0.9037433155080213,0.08288770053475936,0.013368983957219251,0.9010449989336745,0.08232032416293453,0.016634676903390915
Buenos Aires,partido Chacabuco,52409,47049,4001,1359,27019,24194,2115,710,25390,22855,1886,649,0.897727489553321,0.07634184968230648,0.025930660764372532,0.8954439468522151,0.07827824863984603,0.02627780450793886,0.9001575423395037,0.07428121307601418,0.02556124458448208
Buenos Aires,partido Chascomús,42191,38580,2878,733,21680,19753,1537,390,20511,18827,1341,343,0.9144130264748406,0.06821360005688416,0.017373373468275225,0.9111162361623616,0.07089483394833948,0.017988929889298892,0.9178977134220662,0.06537955243527863,0.01672273414265516
Buenos Aires,partido Chivilcoy,70554,64051,4990,1513,36832,33348,2690,794,33722,30703,2300,719,0.9078294639566856,0.070725968761516,0.02144456728179834,0.9054083405734145,0.07303431798436143,0.021557341442224154,0.9104738746219085,0.06820473281537276,0.0213213925627187
Buenos Aires,partido Colón,27406,22906,4112,388,14089,11690,2201,198,13317,11216,1911,190,0.8358023790410859,0.1500401371962344,0.014157483762679704,0.8297253176236781,0.156221165448222,0.014053516928099936,0.8422317338739956,0.1435007884658707,0.014267477660133664
Buenos Aires,partido Coronel de Marina Leonardo Rosales,65823,48739,15918,1166,34150,25217,8214,719,31673,23522,7704,447,0.7404554638955988,0.2418303632468894,0.017714172857511812,0.7384187408491947,0.24052708638360176,0.021054172767203515,0.7426514697060588,0.24323556341363306,0.014112966880308149
Buenos Aires,partido Coronel Dorrego,15795,14834,763,198,8095,7559,423,113,7700,7275,340,85,0.9391579613801836,0.04830642608420386,0.012535612535612535,0.933786287831995,0.0522544780728845,0.013959234095120445,0.9448051948051948,0.04415584415584416,0.01103896103896104
Buenos Aires,partido Coronel Pringles,24110,20857,2930,323,12535,10825,1542,168,11575,10032,1388,155,0.8650767316466197,0.12152633761924513,0.013396930734135214,0.8635819704826486,0.1230155564419625,0.01340247307538891,0.8666954643628509,0.11991360691144709,0.013390928725701945
Buenos Aires,partido Coronel Suárez,41713,39132,2158,423,21416,20006,1151,259,20297,19126,1007,164,0.9381248052165991,0.05173447126795004,0.010140723515450818,0.9341613746731415,0.05374486365334329,0.012093761673515129,0.9423067448391388,0.049613243336453665,0.008080011824407547
Buenos Aires,partido Daireaux,18328,16658,1316,354,9341,8445,681,215,8987,8213,635,139,0.9088825840244434,0.0718027062418158,0.019314709733740724,0.9040787924205117,0.07290439995717803,0.023016807622310245,0.9138755980861244,0.07065761655724936,0.015466785356626237
Buenos Aires,partido Dolores,31405,28861,2029,515,16276,15012,1003,261,15129,13849,1026,254,0.9189937907976437,0.06460754656901767,0.01639866263333864,0.9223396411894814,0.06162447775866306,0.016035881051855494,0.9153942758939785,0.0678167757287329,0.01678894837728865
Buenos Aires,partido Ensenada,63978,56034,5992,1952,32999,28734,3174,1091,30979,27300,2818,861,0.8758323173590922,0.0936571946606646,0.03051048798024321,0.870753659201794,0.09618473287069305,0.033061607927512955,0.8812421317666806,0.09096484715452403,0.02779302107879531
Buenos Aires,partido Escobar,256071,193568,49064,13439,130340,97634,25449,7257,125731,95934,23615,6182,0.7559153516017042,0.19160311007494016,0.052481538323355635,0.7490716587386834,0.19525088230781035,0.05567745895350622,0.7630099179995387,0.18782161917108747,0.04916846282937382
Buenos Aires,partido Esteban Echeverría,337880,248099,57573,32208,174144,126555,30240,17349,163736,121544,27333,14859,0.7342814016810703,0.17039481472712206,0.09532378359180774,0.726726157662624,0.17364939360529216,0.09962444873208379,0.7423169003762153,0.1669333561342649,0.09074974348951971
Buenos Aires,partido Exaltación de la Cruz,40036,29576,8557,1903,20247,15039,4218,990,19789,14537,4339,913,0.7387351383754621,0.2137326406234389,0.04753222100109901,0.7427767076603942,0.20832715957919692,0.048896132760408946,0.7346000303198746,0.21926322704532822,0.04613674263479711
Buenos Aires,partido Ezeiza,198620,147438,37258,13924,101711,74888,19222,7601,96909,72550,18036,6323,0.7423119524720572,0.18758433189004128,0.07010371563790152,0.7362822113635693,0.18898644197776052,0.07473134665867015,0.7486404771486652,0.18611274494628982,0.06524677790504493
Buenos Aires,partido Florencio Varela,488103,385644,73020,29439,249381,194443,38932,16006,238722,191201,34088,13433,0.7900873381233059,0.14959957222143686,0.06031308965525719,0.7797025434977003,0.15611453960004973,0.06418291690224998,0.8009358165564967,0.14279370983822187,0.05627047360528146
Buenos Aires,partido Florentino Ameghino,10759,9109,1488,162,5469,4639,745,85,5290,4470,743,77,0.8466400223069058,0.13830281624686308,0.015057161446231062,0.8482355092338636,0.1362223441214116,0.015542146644724813,0.8449905482041588,0.14045368620037807,0.014555765595463137
Buenos Aires,partido General Alvarado,45307,38561,5866,880,23309,19726,3107,476,21998,18835,2759,404,0.8511046858101398,0.12947226697861258,0.01942304721124771,0.8462825518040242,0.13329615170105968,0.020421296494916127,0.8562142012910264,0.12542049277207018,0.018365305936903355
Buenos Aires,partido General Alvear,10150,9464,608,78,5148,4788,312,48,5002,4676,296,30,0.9324137931034483,0.05990147783251232,0.007684729064039409,0.9300699300699301,0.06060606060606061,0.009324009324009324,0.9348260695721712,0.05917632946821272,0.0059976009596161535
Buenos Aires,partido General Arenales,16231,14211,1828,192,8311,7233,975,103,7920,6978,853,89,0.8755467931735568,0.11262399112808823,0.011829215698355,0.8702923835880159,0.11731440259896522,0.01239321381301889,0.8810606060606061,0.1077020202020202,0.011237373737373737
Buenos Aires,partido General Belgrano,20674,18561,1725,388,10695,9601,883,211,9979,8960,842,177,0.8977943310438231,0.0834381348553739,0.01876753410080294,0.8977092099111734,0.08256194483403459,0.01972884525479196,0.8978855596753181,0.08437719210341718,0.017737248221264657
Buenos Aires,partido General Guido,3157,2929,183,45,1585,1461,100,24,1572,1468,83,21,0.9277795375356351,0.05796642382008236,0.014254038644282548,0.9217665615141956,0.06309148264984227,0.015141955835962145,0.9338422391857506,0.052798982188295165,0.013358778625954198
Buenos Aires,partido General Juan Madariaga,22566,20692,1354,520,11750,10767,711,272,10816,9925,643,248,0.9169547106266064,0.06000177257821501,0.023043516795178586,0.9163404255319149,0.06051063829787234,0.023148936170212766,0.9176220414201184,0.05944896449704142,0.022928994082840236
Buenos Aires,partido General La Madrid,11535,10846,576,113,5902,5515,314,73,5633,5331,262,40,0.940268747290854,0.04993498049414825,0.009796272214997832,0.9344290071162318,0.05320230430362589,0.012368688580142324,0.9463873601988283,0.046511627906976744,0.007101011894194923
Buenos Aires,partido General Las Heras,17980,15345,2298,337,9258,7871,1202,185,8722,7474,1096,152,0.853448275862069,0.1278086763070078,0.01874304783092325,0.8501836249729964,0.12983365737740332,0.019982717649600346,0.856913551937629,0.12565925246503096,0.01742719559734006
Buenos Aires,partido General Lavalle,4846,4250,469,127,2451,2163,219,69,2395,2087,250,58,0.8770119686339248,0.09678085018572018,0.026207181180354932,0.8824969400244798,0.08935128518971848,0.028151774785801713,0.8713987473903967,0.10438413361169102,0.024217118997912318
Buenos Aires,partido General Paz,14141,12526,1361,254,7203,6368,694,141,6938,6158,667,113,0.8857930839403154,0.0962449614595856,0.017961954600099004,0.8840760794113564,0.09634874357906428,0.019575177009579343,0.887575670221966,0.09613721533583165,0.016287114442202363
Buenos Aires,partido General Pinto,12842,11417,1267,158,6521,5788,663,70,6321,5629,604,88,0.8890359757047189,0.09866064475938327,0.012303379535897834,0.887593927311762,0.10167152277258089,0.010734549915657109,0.8905236513209935,0.0955545008701155,0.013921847808890999
Buenos Aires,partido General Pueyrredón,660569,550631,89994,19944,347783,287504,49057,11222,312786,263127,40937,8722,0.8335707549097823,0.13623709256716557,0.030192152523052095,0.8266764045396123,0.1410563483551525,0.03226724710523516,0.8412365003548752,0.13087861988707936,0.027884879758045437
Buenos Aires,partido General Rodríguez,142315,107075,21999,13241,72129,54021,11235,6873,70186,53054,10764,6368,0.7523802831746478,0.15457962969469136,0.09304008713066086,0.748949798278085,0.15576259202262613,0.09528760969928878,0.7559057361867039,0.1533639187302311,0.090730345083065
Buenos Aires,partido General San Martín,444503,324940,82769,36794,232456,167356,44394,20706,212047,157584,38375,16088,0.7310186882878181,0.18620571739673297,0.08277559431544894,0.7199470007227174,0.19097807757166949,0.08907492170561311,0.7431559984343094,0.1809740293425514,0.07586997222313921
Buenos Aires,partido General Viamonte,22530,19356,2589,585,11665,9962,1390,313,10865,9394,1199,272,0.859121171770972,0.11491344873501998,0.02596537949400799,0.8540077153879125,0.1191598799828547,0.026832404629232746,0.8646111366774045,0.11035434882650713,0.02503451449608836
Buenos Aires,partido General Villegas,35055,28076,6356,623,17709,14149,3213,347,17346,13927,3143,276,0.8009128512337755,0.1813150763086578,0.017772072457566682,0.7989722739849794,0.18143316957479247,0.019594556440228134,0.8028940389715208,0.18119451170298628,0.015911449325492908
Buenos Aires,partido Guaminí,11662,10724,802,136,5883,5410,400,73,5779,5314,402,63,0.9195678271308524,0.06877036528897273,0.011661807580174927,0.919598844127146,0.0679925208227095,0.012408635050144484,0.9195362519467036,0.06956220799446271,0.010901540058833708
Buenos Aires,partido Hipólito Yrigoyen,10581,9578,851,152,5367,4869,421,77,5214,4709,430,75,0.9052074473112183,0.080427180795766,0.014365371893015783,0.9072107322526551,0.07844233277436184,0.014346934972983045,0.9031453778289221,0.08247027234369006,0.014384349827387802
Buenos Aires,partido Hurlingham,185361,142368,34381,8612,96371,72593,18879,4899,88990,69775,15502,3713,0.7680580057293606,0.185481304049935,0.04646069022070446,0.7532660240113728,0.195899181288977,0.05083479469965031,0.7840768625688279,0.17419934824137542,0.041723789189796606
Buenos Aires,partido Ituzaingó,177983,135210,36148,6625,92829,69549,19475,3805,85154,65661,16673,2820,0.7596792952135878,0.20309804869004344,0.03722265609636875,0.7492163009404389,0.2097943530577729,0.04098934600178823,0.7710853277591188,0.19579820090659275,0.033116471334288466
Buenos Aires,partido José C. Paz,326527,247812,56516,22199,167300,125636,29725,11939,159227,122176,26791,10260,0.7589326456923929,0.17308216472144722,0.0679851895861598,0.7509623430962343,0.1776748356246264,0.07136282127913927,0.7673070521959215,0.16825663989147568,0.06443630791260276
Buenos Aires,partido Junín,100964,89552,9397,2015,52663,46650,4960,1053,48301,42902,4437,962,0.8869696129313419,0.09307277841606909,0.01995760865258904,0.8858211647646355,0.0941837722879441,0.01999506294742039,0.8882217759466677,0.09186145214384796,0.019916771909484276
Buenos Aires,partido La Costa,100400,78275,15965,6160,51754,40143,8383,3228,48646,38132,7582,2932,0.7796314741035857,0.15901394422310758,0.06135458167330677,0.7756501912895621,0.1619778181396607,0.062371990570777136,0.7838671216544012,0.15586070797187848,0.060272170373720346
Buenos Aires,partido La Matanza,1837168,1368951,314227,153990,952170,703564,165561,83045,884998,665387,148666,70945,0.7451419793943722,0.17103879449239265,0.08381922611323515,0.7389058676496844,0.17387756388039952,0.08721656846991609,0.7518514166133708,0.16798456041708568,0.08016402296954343
Buenos Aires,partido Lanús,460081,324927,107138,28016,242122,168810,56964,16348,217959,156117,50174,11668,0.7062386840578072,0.2328676906892482,0.06089362525294459,0.6972104971873684,0.23526982265139063,0.06751968016124103,0.7162677384278695,0.23019925765855045,0.053533003913580075
Buenos Aires,partido La Plata,756074,619022,80540,56512,395876,321678,43825,30373,360198,297344,36715,26139,0.8187320288754805,0.10652396458547708,0.07474400653904248,0.8125726237508715,0.11070385676322889,0.07672351948589963,0.8255015297142128,0.10193004958384,0.07256842070194726
Buenos Aires,partido Laprida,11496,10911,514,71,5943,5635,264,44,5553,5276,250,27,0.9491127348643006,0.044711203897007654,0.006176061238691719,0.9481743227326266,0.04442200908632004,0.00740366818105334,0.9501170538447686,0.04502070952638214,0.004862236628849271
Buenos Aires,partido Las Flores,27136,24831,1953,352,14092,12871,1028,193,13044,11960,925,159,0.9150574882075472,0.07197081367924528,0.012971698113207548,0.9133550950894125,0.07294919103037184,0.013695713880215725,0.9168966574670346,0.07091383011346213,0.01218951241950322
Buenos Aires,partido Leandro N. Alem,17153,15574,1434,145,8771,7943,756,72,8382,7631,678,73,0.9079461318719757,0.08360053634932665,0.008453331778697604,0.9055979933872991,0.08619313647246608,0.008208870140234865,0.9104032450489143,0.08088761632068718,0.008709138630398473
Buenos Aires,partido Lezama,6170,5771,282,117,3180,2959,162,59,2990,2812,120,58,0.9353322528363047,0.045705024311183146,0.018962722852512156,0.930503144654088,0.0509433962264151,0.018553459119496855,0.9404682274247491,0.04013377926421405,0.01939799331103679
Buenos Aires,partido Lincoln,45191,41303,3494,394,23176,21172,1788,216,22015,20131,1706,178,0.9139651700559845,0.07731627979022372,0.008718550153791685,0.913531239212979,0.07714877459440801,0.009319986192613048,0.9144219850102203,0.07749261866908926,0.008085396320690438
Buenos Aires,partido Lobería,18106,16946,1021,139,9135,8578,463,94,8971,8368,558,45,0.9359328399425605,0.05639014691262565,0.0076770131448138735,0.9390257252326217,0.05068418171866448,0.010290093048713738,0.9327834132203767,0.062200423587114036,0.005016163192509197
Buenos Aires,partido Lobos,41418,36961,3569,888,21463,19146,1843,474,19955,17815,1726,414,0.8923897822202906,0.08617026413636583,0.021439953643343473,0.8920467781763965,0.08586870428178726,0.02208451754181615,0.8927587070909546,0.0864946128789777,0.020746680030067653
Buenos Aires,partido Lomas de Zamora,685644,512877,110858,61909,356111,263513,59089,33509,329533,249364,51769,28400,0.7480222972854718,0.16168448932682267,0.09029321338770557,0.7399743338453459,0.16592860091376005,0.09409706524089399,0.7567193573936449,0.15709807515484034,0.08618256745151472
Buenos Aires,partido Luján,110111,92655,14547,2909,57042,47949,7509,1584,53069,44706,7038,1325,0.8414690630363906,0.1321121413846028,0.02641879557900664,0.8405911433680446,0.13163984432523404,0.027769012306721363,0.8424127079839454,0.13261979686822817,0.024967495147826414
Buenos Aires,partido Magdalena,22653,18662,3347,644,11492,9476,1671,345,11161,9186,1676,299,0.8238202445592195,0.14775084977707148,0.028428905663709002,0.8245736164288201,0.14540549947789766,0.030020884093282282,0.8230445300600304,0.15016575575665264,0.026789714183316906
Buenos Aires,partido Maipú,11253,10714,462,77,5862,5614,214,34,5391,5100,248,43,0.9521016617790812,0.04105571847507331,0.006842619745845552,0.9576936199249403,0.03650631183896281,0.005800068236096895,0.9460211463550362,0.04600259692079391,0.007976256724169913
Buenos Aires,partido Malvinas Argentinas,349401,271326,65984,12091,179550,137338,35268,6944,169851,133988,30716,5147,0.776546146118643,0.18884891571575355,0.03460493816560342,0.764901141743247,0.19642439431913117,0.038674463937621834,0.7888561150655574,0.18084085463141225,0.030303030303030304
Buenos Aires,partido Mar Chiquita,32973,28220,3959,794,16643,14212,2025,406,16330,14008,1934,388,0.8558517574985595,0.1200679343705456,0.024080308130894974,0.8539325842696629,0.1216727753409842,0.024394640389352882,0.8578077158603796,0.11843233312921005,0.02375995101041029
Buenos Aires,partido Marcos Paz,64761,52115,9676,2970,33015,26568,4868,1579,31746,25547,4808,1391,0.8047281542903908,0.14941091088772565,0.04586093482188354,0.8047251249432076,0.14744812963804332,0.04782674541874905,0.8047313047313047,0.15145215145215146,0.04381654381654382
Buenos Aires,partido Mercedes,71002,61082,8458,1462,36823,31659,4395,769,34179,29423,4063,693,0.8602856257570209,0.11912340497450775,0.020590969268471312,0.8597615620671862,0.1193547511066453,0.020883686826168427,0.8608502296731911,0.11887416249743994,0.02027560782936891
Buenos Aires,partido Merlo,581484,454712,96250,30522,299398,231139,51497,16762,282086,223573,44753,13760,0.781985402865771,0.1655247607844756,0.05248983634975339,0.7720125050935543,0.17200181697940534,0.05598567792704026,0.7925703508859,0.15865019887552023,0.04877945023857972
Buenos Aires,partido Monte,24616,20419,3415,782,12613,10439,1776,398,12003,9980,1639,384,0.8295011374715632,0.13873090672733182,0.031767955801104975,0.82763815111393,0.1408071037818124,0.031554745104257514,0.8314588019661752,0.13654919603432475,0.03199200199950013
Buenos Aires,partido Monte Hermoso,8444,7183,947,314,4255,3634,479,142,4189,3549,468,172,0.850663192799621,0.1121506395073425,0.037186167693036475,0.8540540540540541,0.11257344300822562,0.03337250293772033,0.8472189066603008,0.11172117450465505,0.04105991883504417
Buenos Aires,partido Moreno,575758,422761,96667,56330,294448,213893,50741,29814,281310,208868,45926,26516,0.7342685642231632,0.1678951920772269,0.0978362436996099,0.7264202847361844,0.17232584361245448,0.1012538716513612,0.7424833813230955,0.16325761615299847,0.09425900252390601
Buenos Aires,partido Morón,329517,247169,66005,16343,173315,128294,35533,9488,156202,118875,30472,6855,0.7500948357747855,0.20030833007098267,0.0495968341542318,0.7402359864985719,0.20501976170556502,0.05474425179586302,0.761033789580159,0.19508072879988733,0.04388548161995365
Buenos Aires,partido Navarro,19888,18261,1316,311,10107,9286,659,162,9781,8975,657,149,0.9181918744971842,0.06617055510860821,0.015637570394207562,0.9187691698822599,0.0652023350153359,0.016028495102404273,0.9175953379000102,0.06717104590532666,0.015233616194663123
Buenos Aires,partido Necochea,101483,92403,7271,1809,53024,48106,3864,1054,48459,44297,3407,755,0.9105268862765192,0.07164746804883576,0.017825645674645015,0.9072495473747737,0.07287266143633071,0.019877791188895596,0.914112961472585,0.07030685734332116,0.01558018118409377
Buenos Aires,partido 9 de Julio,52366,48356,3343,667,27178,25088,1726,364,25188,23268,1617,303,0.9234235954627048,0.06383913226139099,0.012737272275904212,0.9230995658252998,0.06350724850982412,0.013393185664876003,0.9237732253454026,0.06419723677941877,0.012029537875178657
Buenos Aires,partido Olavarría,122011,112531,7311,2169,63155,58101,3861,1193,58856,54430,3450,976,0.9223020875166993,0.059920826810697395,0.01777708567260329,0.9199746655055023,0.06113530203467659,0.018890032459821075,0.9247995106701101,0.05861764306103031,0.01658284626885959
Buenos Aires,partido Patagones,37499,25642,10612,1245,19043,12929,5502,612,18456,12713,5110,633,0.683804901464039,0.28299421317901813,0.03320088535694285,0.6789371422569973,0.28892506432809956,0.03213779341490312,0.6888274815778067,0.2768747290853923,0.03429778933680104
Buenos Aires,partido Pehuajó,44594,40303,3621,670,23173,20937,1880,356,21421,19366,1741,314,0.9037762927748128,0.08119926447504149,0.015024442750145759,0.9035083933888577,0.0811289000129461,0.015362706598196177,0.9040661033565193,0.08127538396900238,0.014658512674478315
Buenos Aires,partido Pellegrini,7112,5901,1120,91,3631,2992,595,44,3481,2909,525,47,0.8297244094488189,0.15748031496062992,0.012795275590551181,0.8240154227485541,0.16386670338749657,0.012117873863949325,0.8356794024705544,0.15081873024992817,0.01350186727951738
Buenos Aires,partido Pergamino,114988,98564,14645,1779,59918,50987,7990,941,55070,47577,6655,838,0.8571677044561171,0.12736111594253313,0.015471179601349706,0.8509462932674655,0.13334891017724224,0.015704796555292232,0.8639368076992918,0.12084619575086254,0.015216996549845652
Buenos Aires,partido Pila,4615,3967,509,139,2343,2033,237,73,2272,1934,272,66,0.8595882990249187,0.11029252437703142,0.030119176598049836,0.8676909944515578,0.10115236875800256,0.031156636790439608,0.8512323943661971,0.11971830985915492,0.029049295774647887
Buenos Aires,partido Pilar,393614,283352,80659,29603,200878,143806,41047,16025,192736,139546,39612,13578,0.719872768753144,0.20491903235149156,0.0752081988953645,0.7158872549507661,0.204337956371529,0.07977478867770488,0.7240266478499087,0.2055246554872987,0.07044869666279263
Buenos Aires,partido Pinamar,39224,26811,7768,4645,19817,13516,3927,2374,19407,13295,3841,2271,0.6835355904548236,0.19804201509280034,0.1184223944523761,0.682040672150174,0.19816319321794418,0.11979613463188171,0.6850620909980935,0.19791827691039315,0.11701963209151336
Buenos Aires,partido Presidente Perón,101994,77231,15763,9000,52044,39107,8092,4845,49950,38124,7671,4155,0.7572112085024609,0.15454830676314293,0.08824048473439614,0.7514218737990931,0.1554838213819076,0.0930943048189993,0.7632432432432432,0.15357357357357357,0.08318318318318318
Buenos Aires,partido Puán,16391,14038,2045,308,8367,7084,1110,173,8024,6954,935,135,0.856445610395949,0.12476358977487646,0.018790799829174545,0.846659495637624,0.13266403728935103,0.02067646707302498,0.8666500498504487,0.11652542372881355,0.016824526420737788
Buenos Aires,partido Punta Indio,12161,9895,1885,381,6175,5003,967,205,5986,4892,918,176,0.8136666392566401,0.15500370035358935,0.03132966038977058,0.8102024291497976,0.1565991902834008,0.03319838056680162,0.8172402271967926,0.1533578349482125,0.029401937854994988
Buenos Aires,partido Quilmes,631774,497577,90229,43968,328275,255018,48768,24489,303499,242559,41461,19479,0.7875870168762881,0.1428184762272585,0.06959450689645348,0.7768425862462874,0.14855837331505597,0.07459904043865662,0.7992085641138851,0.13661000530479508,0.06418143058131988
Buenos Aires,partido Ramallo,39648,33760,5534,354,20222,17214,2819,189,19426,16546,2715,165,0.8514931396287329,0.13957828894269572,0.008928571428571428,0.8512511126495895,0.13940263079814064,0.009346256552269805,0.8517450839081643,0.1397611448574076,0.008493771234428085
Buenos Aires,partido Rauch,16491,15504,789,198,8323,7809,400,114,8168,7695,389,84,0.9401491722757868,0.04784427869747135,0.012006549026741859,0.9382434218430854,0.04805959389643157,0.013696984260482999,0.9420910871694417,0.04762487757100881,0.01028403525954946
Buenos Aires,partido Rivadavia,19735,16204,3265,266,9946,8101,1709,136,9789,8103,1556,130,0.8210793007347352,0.16544210793007347,0.013478591335191284,0.8144982907701589,0.1718278705007038,0.013673838729137341,0.8277658596383696,0.15895392787823068,0.013280212483399735
Buenos Aires,partido Rojas,25619,22737,2604,278,13200,11715,1346,139,12419,11022,1258,139,0.8875053671103478,0.10164331160466841,0.010851321284983801,0.8875,0.10196969696969697,0.01053030303030303,0.887511071744907,0.10129640067638296,0.01119252757871004
Buenos Aires,partido Roque Pérez,13901,12080,1644,177,7117,6221,798,98,6784,5859,846,79,0.8690022300553917,0.11826487303071721,0.012732896913891087,0.8741042574118308,0.11212589574258817,0.013769846845581003,0.8636497641509434,0.12470518867924528,0.01164504716981132
Buenos Aires,partido Saavedra,21407,19063,1988,356,10980,9797,982,201,10427,9266,1006,155,0.8905031064605036,0.0928668192647265,0.016630074274769934,0.8922586520947177,0.08943533697632058,0.01830601092896175,0.8886544547808574,0.09648029155078162,0.014865253668360986
Buenos Aires,partido Saladillo,35423,32680,2058,685,18172,16776,1035,361,17251,15904,1023,324,0.9225644355362336,0.05809784603223894,0.01933771843152754,0.9231785163988554,0.056955756108298485,0.01986572749284614,0.9219175699959422,0.05930091009216857,0.018781519911889165
Buenos Aires,partido Salliqueló,9344,8541,698,105,4750,4334,360,56,4594,4207,338,49,0.9140625,0.07470034246575342,0.011237157534246575,0.9124210526315789,0.07578947368421053,0.011789473684210527,0.9157596865476709,0.07357422725293862,0.01066608619939051
Buenos Aires,partido Salto,39257,32809,5694,754,20038,16759,2901,378,19219,16050,2793,376,0.8357490383880581,0.14504419593957765,0.019206765672364165,0.8363609142629005,0.14477492763748878,0.01886415809961074,0.8351110879858473,0.1453249388625839,0.01956397315156876
Buenos Aires,partido San Andrés de Giles,26399,22922,2928,549,13304,11620,1413,271,13095,11302,1515,278,0.8682904655479374,0.11091329217015795,0.020796242281904617,0.8734215273601924,0.1062086590499098,0.020369813589897773,0.8630775105001909,0.1156930126002291,0.02122947689957999
Buenos Aires,partido San Antonio de Areco,26695,22305,3805,585,13717,11462,1940,315,12978,10843,1865,270,0.8355497284135606,0.14253605544109385,0.02191421614534557,0.8356054530874097,0.14143034191149667,0.022964205001093533,0.8354908306364617,0.14370473108337187,0.020804438280166437
Buenos Aires,partido San Cayetano,8918,8226,602,90,4533,4194,286,53,4385,4032,316,37,0.9224041264857591,0.06750392464678179,0.010091948867459071,0.9252150893448048,0.06309287447606442,0.011692036179130819,0.9194982896237173,0.07206385404789054,0.008437856328392246
Buenos Aires,partido San Fernando,171099,131457,29408,10234,89489,67902,15741,5846,81610,63555,13667,4388,0.7683095751582417,0.1718771003921706,0.05981332444958767,0.7587748214864397,0.17589871380840102,0.06532646470515929,0.7787648572478862,0.16746722215414778,0.05376792059796594
Buenos Aires,partido San Isidro,295978,208919,70190,16869,156763,109332,37457,9974,139215,99587,32733,6895,0.7058598949921954,0.23714600409489894,0.05699410091290569,0.6974349814688415,0.23894031117036546,0.06362470736079305,0.7153467657939159,0.23512552526667385,0.04952770893941026
Buenos Aires,partido San Miguel,327650,242971,66191,18488,169340,124135,34984,10221,158310,118836,31207,8267,0.7415565389897757,0.20201739661223866,0.056426064397985656,0.7330518483524271,0.2065902917207984,0.06035785992677454,0.7506537805571347,0.19712589223675067,0.05222032720611459
Buenos Aires,partido San Nicolás,166657,132823,30898,2936,86079,67691,16739,1649,80578,65132,14159,1287,0.796984225085055,0.1853987531276814,0.01761702178726366,0.78638227674578,0.19446090219449574,0.019156821059724206,0.8083099605351337,0.17571793789868204,0.015972101566184317
Buenos Aires,partido San Pedro,68353,59882,7778,693,35068,30803,3898,367,33285,29079,3880,326,0.8760698140535164,0.1137916404546984,0.010138545491785292,0.8783791490817839,0.11115546937378806,0.010465381544427969,0.873636773321316,0.11656902508637525,0.009794201592308848
Buenos Aires,partido San Vicente,97929,79620,13533,4776,49944,40233,7145,2566,47985,39387,6388,2210,0.8130380173390926,0.13819195539625648,0.04877002726465092,0.8055622296972609,0.1430602274547493,0.051377542847989746,0.8208190059393561,0.1331249348754819,0.04605605918516203
Buenos Aires,partido Suipacha,11736,10606,1003,127,6007,5425,513,69,5729,5181,490,58,0.9037150647580096,0.08546353101567826,0.010821404226312201,0.9031130347927419,0.08540036623938738,0.011486598967870817,0.9043463082562402,0.08552976086577065,0.010123930877989178
Buenos Aires,partido Tandil,144678,129556,12499,2623,75152,67238,6451,1463,69526,62318,6048,1160,0.8954782344240313,0.08639184948644577,0.01812991608952294,0.8946934213327656,0.08583936555248031,0.0194672131147541,0.8963265540948709,0.08698904007134022,0.016684405833788798
Buenos Aires,partido Tapalqué,10695,9823,722,150,5440,4999,354,87,5255,4824,368,63,0.9184665731650304,0.06750818139317438,0.014025245441795231,0.9189338235294118,0.06507352941176471,0.015992647058823528,0.9179828734538534,0.07002854424357755,0.011988582302568981
Buenos Aires,partido Tigre,446291,333881,87600,24810,229776,170023,45845,13908,216515,163858,41755,10902,0.7481239818862581,0.1962844870275224,0.05559153108621953,0.7399510827936773,0.19952040247893602,0.06052851472738667,0.7567974505230585,0.19285037988130152,0.050352169595640026
Buenos Aires,partido Tordillo,2528,2320,183,25,1219,1124,85,10,1309,1196,98,15,0.9177215189873418,0.07238924050632911,0.009889240506329115,0.9220672682526662,0.06972928630024611,0.008203445447087777,0.9136745607333843,0.0748663101604278,0.01145912910618793
Buenos Aires,partido Tornquist,14591,12695,1511,385,7426,6444,781,201,7165,6251,730,184,0.8700568843807827,0.10355698718388047,0.02638612843533685,0.867761917586857,0.10517102073794775,0.02706706167519526,0.8724354501046755,0.10188415910676901,0.02568039078855548
Buenos Aires,partido Trenque Lauquen,49128,43573,4943,612,25036,22305,2426,305,24092,21268,2517,307,0.8869280247516691,0.10061472072952288,0.012457254518808011,0.8909170794056559,0.09690046333280077,0.012182457261543378,0.882782666445293,0.10447451436161381,0.012742819193093143
Buenos Aires,partido Tres Arroyos,61889,58188,2867,834,31784,29841,1509,434,30105,28347,1358,400,0.9401993892291037,0.046324871948165265,0.013475738822731018,0.9388686131386861,0.04747671784545683,0.013654669015857036,0.941604384653712,0.045108785915960806,0.013286829430327189
Buenos Aires,partido Tres de Febrero,362319,258938,75764,27617,190090,133943,40543,15604,172229,124995,35221,12013,0.7146685655458311,0.20910854799223888,0.07622288646192996,0.7046293860802778,0.213283181650797,0.08208743226892525,0.7257488576256031,0.20450098415481713,0.06975015821957975
Buenos Aires,partido Tres Lomas,9090,8100,870,120,4564,4045,458,61,4526,4055,412,59,0.8910891089108911,0.09570957095709572,0.013201320132013201,0.8862839614373357,0.10035056967572305,0.01336546888694128,0.8959346000883782,0.09102960671674767,0.013035793194874062
Buenos Aires,partido 25 de Mayo,35411,32693,2276,442,18227,16800,1169,258,17184,15893,1107,184,0.9232441896585807,0.06427381322188021,0.012481997119539127,0.9217095517638668,0.0641356229769024,0.014154825259230812,0.9248719739292365,0.06442039106145252,0.010707635009310988
Buenos Aires,partido Vicente López,280541,179444,82149,18948,149510,94486,43829,11195,131031,84958,38320,7753,0.6396355612905066,0.2928235088632321,0.06754092984626132,0.6319711056116648,0.29315095980201994,0.0748779345863153,0.648380917492807,0.29244987827308044,0.05916920423411254
Buenos Aires,partido Villa Gesell,37325,28123,6527,2675,19242,14347,3499,1396,18083,13776,3028,1279,0.7534628265237776,0.17486939048894842,0.07166778298727394,0.7456085645982746,0.18184180438623843,0.07254963101548696,0.7618204943869933,0.16745009124592158,0.0707294143670851
Buenos Aires,partido Villarino,32552,25355,4010,3187,16181,12705,1878,1598,16371,12650,2132,1589,0.7789075940034407,0.12318751536003932,0.09790489063652003,0.7851801495581238,0.11606204808108275,0.09875780236079353,0.7727078370288926,0.13023028526052166,0.09706187771058579
Buenos Aires,partido Zárate,131415,109224,19395,2796,67273,55830,9920,1523,64142,53394,9475,1273,0.83113799794544,0.14758589202145875,0.021276110033101245,0.8299020409376718,0.14745886165326358,0.022639097409064557,0.8324342864269901,0.1477191231954102,0.019846590377599702
Ciudad Autónoma de Buenos Aires,Comuna 1,221001,110628,56104,54269,115959,56749,29802,29408,105042,53879,26302,24861,0.5005769204664232,0.253863104691834,0.2455599748417428,0.48938849075966506,0.2570046309471451,0.25360687829318984,0.5129281620685059,0.2503950800632128,0.23667675786828127
Ciudad Autónoma de Buenos Aires,Comuna 2,160609,93683,46733,20193,90302,51344,27115,11843,70307,42339,19618,8350,0.5832985698186278,0.2909737312354849,0.12572769894588723,0.5685809838098824,0.3002702044251512,0.13114881176496646,0.6022017722275165,0.2790333821667828,0.1187648456057007
Ciudad Autónoma de Buenos Aires,Comuna 3,193537,104957,49314,39266,104323,55096,27459,21768,89214,49861,21855,17498,0.542309739222991,0.2548039909681353,0.20288626980887375,0.5281289840207816,0.2632113723723436,0.2086596436068748,0.558892102136436,0.24497276212253682,0.1961351357410272
Ciudad Autónoma de Buenos Aires,Comuna 4,227024,147991,41546,37487,119835,76197,22501,21137,107189,71794,19045,16350,0.6518738106984283,0.1830026781309465,0.16512351117062513,0.6358492927775692,0.18776651228772895,0.1763841949347019,0.6697888775900512,0.17767681385216766,0.1525343085577811
Ciudad Autónoma de Buenos Aires,Comuna 5,192449,122727,44718,25004,105002,65362,25484,14156,87447,57365,19234,10848,0.6377118093624804,0.23236285977064053,0.12992533086687902,0.6224833812689282,0.24270013904497056,0.13481647968610122,0.655997346964447,0.21995036993836267,0.1240522830971903
Ciudad Autónoma de Buenos Aires,Comuna 6,201764,140265,42196,19303,110746,75455,24174,11117,91018,64810,18022,8186,0.6951933942626038,0.2091354255466783,0.09567118019071787,0.6813338630740614,0.21828327885431528,0.10038285807162335,0.7120569557669911,0.198004790261267,0.08993825397174185
Ciudad Autónoma de Buenos Aires,Comuna 7,213262,149967,33083,30212,113904,78491,18680,16733,99358,71476,14403,13479,0.7032054468212808,0.15512843356997497,0.14166611960874417,0.6890978367748279,0.1639977524933277,0.14690441073184435,0.7193784093882727,0.14496064735602568,0.1356609432557016
Ciudad Autónoma de Buenos Aires,Comuna 8,203888,136369,26367,41152,107116,70136,14327,22653,96772,66233,12040,18499,0.6688426979518167,0.12932099976457664,0.2018363022836067,0.6547667948765824,0.13375219388326673,0.21148101124015087,0.6844231802587525,0.12441615343281115,0.1911606663084363
Ciudad Autónoma de Buenos Aires,Comuna 9,167908,124890,22847,20171,88417,64459,12714,11244,79491,60431,10133,8927,0.7438001762870143,0.13606856135502776,0.12013126235795793,0.7290340092968547,0.14379587635861882,0.1271701143445265,0.7602244279226579,0.1274735504648325,0.11230202161250959
Ciudad Autónoma de Buenos Aires,Comuna 10,171896,130011,24971,16914,91566,67926,14157,9483,80330,62085,10814,7431,0.7563352259505748,0.14526806906501605,0.09839670498440918,0.741825568442435,0.15460978965991742,0.1035646418976476,0.7728743931283456,0.1346196937632267,0.09250591310842773
Ciudad Autónoma de Buenos Aires,Comuna 11,201905,152964,33134,15807,108217,80388,18779,9050,93688,72576,14355,6757,0.7576038235803967,0.16410688194943165,0.07828929447017162,0.7428407736307604,0.17353096093959358,0.08362826542964599,0.7746563060370592,0.15322133037315344,0.07212236358978738
Ciudad Autónoma de Buenos Aires,Comuna 12,235364,174499,43071,17794,126101,91669,24270,10162,109263,82830,18801,7632,0.7414005540354515,0.18299739977226764,0.07560204619228089,0.7269490329180578,0.1924647703031697,0.08058619677877257,0.7580791301721534,0.17207105790615304,0.06984981192169352
Ciudad Autónoma de Buenos Aires,Comuna 13,262330,177741,57719,26870,143839,95628,32753,15458,118491,82113,24966,11412,0.6775473640071665,0.22002439675218236,0.10242823924065109,0.6648266464588881,0.22770597682130717,0.10746737671980479,0.6929893409626048,0.21069954680102287,0.09631111223637238
Ciudad Autónoma de Buenos Aires,Comuna 14,247252,151559,64756,30937,136640,82232,36752,17656,110612,69327,28004,13281,0.61297380809862,0.2619028359730154,0.12512335592836457,0.6018149882903981,0.2689695550351288,0.12921545667447307,0.6267583987270821,0.25317325425812753,0.12006834701479044
Ciudad Autónoma de Buenos Aires,Comuna 15,195265,133472,38081,23712,104706,69839,21531,13336,90559,63633,16550,10376,0.683542877627839,0.19502214938673085,0.12143497298543006,0.6670009359540046,0.20563291501919662,0.12736614902679885,0.7026689782351837,0.18275378482536248,0.11457723693945383
Catamarca,departamento Ambato,5087,4563,509,15,2519,2247,262,10,2568,2316,247,5,0.8969923333988599,0.10005897385492432,0.0029486927462158445,0.8920206431123462,0.10400952759031362,0.003969829297340214,0.9018691588785047,0.09618380062305296,0.0019470404984423676
Catamarca,departamento Ancasti,3282,2858,411,13,1539,1340,191,8,1743,1518,220,5,0.870810481413772,0.12522851919561243,0.003960999390615478,0.8706952566601689,0.12410656270305392,0.005198180636777128,0.8709122203098106,0.12621916236374067,0.002868617326448652
Catamarca,departamento Andalgalá,19545,16490,2978,77,9841,8268,1532,41,9704,8222,1446,36,0.8436940393962651,0.15236633410079303,0.003939626502941929,0.8401585204755614,0.155675236256478,0.004166243267960573,0.8472794723825227,0.14901071723000825,0.003709810387469085
Catamarca,departamento Antofagasta de la Sierra,1822,1676,142,4,873,795,74,4,949,881,68,0,0.9198682766190999,0.07793633369923161,0.0021953896816684962,0.9106529209621993,0.08476517754868271,0.004581901489117984,0.928345626975764,0.07165437302423604,0.0
Catamarca,departamento Belén,30353,27692,2593,68,15486,14145,1309,32,14867,13547,1284,36,0.9123315652489046,0.08542812901525385,0.002240305735841597,0.9134056567222006,0.08452796073873176,0.002066382539067545,0.9112127530772852,0.08636577655209525,0.0024214703706194928
Catamarca,departamento Capayán,19471,16381,2891,199,9708,8182,1430,96,9763,8199,1461,103,0.8413024497971342,0.14847722253607928,0.010220327666786502,0.8428100535640709,0.1473011948908117,0.009888751545117428,0.8398033391375602,0.14964662501280343,0.010550035849636383
Catamarca,departamento Capital,186466,162090,23342,1034,96933,84108,12309,516,89533,77982,11033,518,0.8692737550009116,0.12518099814443384,0.005545246854654468,0.8676921172356163,0.12698461824146576,0.005323264522917892,0.8709861168507701,0.12322830688126166,0.005785576267968235
Catamarca,departamento El Alto,4375,2718,1647,10,2144,1291,848,5,2231,1427,799,5,0.6212571428571428,0.3764571428571429,0.002285714285714286,0.6021455223880597,0.39552238805970147,0.0023320895522388058,0.6396234872254595,0.3581353653070372,0.0022411474675033617
Catamarca,departamento Fray Mamerto Esquiú,14624,12816,1699,109,7384,6438,881,65,7240,6378,818,44,0.8763676148796499,0.1161788840262582,0.007453501094091904,0.8718851570964247,0.11931202600216685,0.008802816901408451,0.880939226519337,0.11298342541436464,0.0060773480662983425
Catamarca,departamento La Paz,26341,19814,6365,162,13292,10042,3166,84,13049,9772,3199,78,0.7522113814965263,0.24163851030712577,0.0061501081963478985,0.7554920252783629,0.23818838399037015,0.006319590731266927,0.7488696451835389,0.2451528852785654,0.005977469537895624
Catamarca,departamento Paclín,4696,3953,717,26,2281,1881,389,11,2415,2072,328,15,0.8417802385008518,0.1526831345826235,0.005536626916524702,0.8246383165278387,0.1705392371766769,0.004822446295484437,0.8579710144927536,0.13581780538302277,0.006211180124223602
Catamarca,departamento Pomán,12219,10099,2059,61,6068,5017,1023,28,6151,5082,1036,33,0.8264997135608478,0.1685080612161388,0.00499222522301334,0.8267963085036256,0.16858932102834542,0.004614370468029005,0.8262071207933669,0.16842789790278004,0.005364981303853032
Catamarca,departamento Santa María,26822,21815,4906,101,13794,11177,2564,53,13028,10638,2342,48,0.8133248825590933,0.1829095518604131,0.0037655655804936248,0.8102798318109323,0.1858779179353342,0.0038422502537335075,0.816548971446116,0.17976665643229967,0.00368437212158428
Catamarca,departamento Santa Rosa,13317,9320,3932,65,6635,4611,1989,35,6682,4709,1943,30,0.6998573252233987,0.29526169557708193,0.004880979199519411,0.6949510173323286,0.2997739261492087,0.0052750565184626974,0.7047291230170608,0.2907812032325651,0.004489673750374139
Catamarca,departamento Tinogasta,25254,22074,3053,127,12766,11090,1610,66,12488,10984,1443,61,0.8740793537657401,0.12089173992238854,0.005028906311871387,0.8687137709540969,0.12611624627917906,0.005169982766724111,0.8795643818065343,0.11555092889173607,0.004884689301729661
Catamarca,departamento Valle Viejo,33951,29100,4691,160,17274,14829,2365,80,16677,14271,2326,80,0.857117610674207,0.13816971517775617,0.004712674148036877,0.8584577978464745,0.13691096445525067,0.004631237698274864,0.8557294477423997,0.13947352641362357,0.004797025843976735
Chaco,departamento Almirante Brown,37794,32584,5102,108,19066,16498,2520,48,18728,16086,2582,60,0.8621474308091231,0.13499497274699687,0.002857596443879981,0.8653099758732823,0.1321724535822931,0.00251757054442463,0.8589278086287911,0.1378684322938915,0.0032037590773173856
Chaco,departamento Bermejo,28060,24880,2802,378,14279,12649,1402,228,13781,12231,1400,150,0.8866714183891661,0.09985744832501782,0.013471133285816108,0.8858463477834583,0.09818614748931997,0.015967504727221794,0.8875263043320514,0.10158914447427618,0.010884551193672447
Chaco,departamento Chacabuco,34493,31211,3188,94,17727,16086,1596,45,16766,15125,1592,49,0.9048502594729365,0.09242454990867713,0.0027251906183863393,0.9074293450668471,0.09003215434083602,0.002538500592316805,0.902123344864607,0.09495407372062507,0.002922581414767983
Chaco,departamento Comandante Fernández,101086,92987,7757,342,53023,48800,4050,173,48063,44187,3707,169,0.9198801020912886,0.0767366400886374,0.0033832578200739963,0.9203553175037248,0.07638194745676405,0.0032627350395111557,0.9193558454528431,0.07712793625033809,0.0035162182968187586
Chaco,departamento 12 de Octubre,23179,20925,2200,54,11689,10568,1095,26,11490,10357,1105,28,0.9027568057293239,0.09491349928814875,0.0023296949825272876,0.9040978697921123,0.09367781675079134,0.0022243134570964153,0.9013925152306353,0.09617058311575283,0.0024369016536118365
Chaco,departamento 2 de Abril,8310,7636,652,22,4184,3856,318,10,4126,3780,334,12,0.918892900120337,0.07845968712394705,0.002647412755716005,0.9216061185468452,0.07600382409177821,0.002390057361376673,0.9161415414444983,0.08095007270964615,0.00290838584585555
Chaco,departamento Fray Justo Santa María de Oro,10643,9676,951,16,5335,4837,493,5,5308,4839,458,11,0.9091421591656488,0.08935450530865358,0.0015033355256976416,0.9066541705716964,0.09240862230552953,0.0009372071227741331,0.9116428033157498,0.08628485305199698,0.002072343632253203
Chaco,departamento General Belgrano,12807,12057,722,28,6468,6077,379,12,6339,5980,343,16,0.9414382759428438,0.056375419692355745,0.0021863043648004997,0.9395485466914039,0.05859616573902288,0.0018552875695732839,0.9433664615870011,0.054109480990692536,0.0025240574223063575
Chaco,departamento General Donovan,15061,14093,911,57,7592,7115,454,23,7469,6978,457,34,0.9357280393068189,0.06048735143748755,0.003784609255693513,0.9371707060063225,0.059799789251844045,0.003029504741833509,0.9342616146739858,0.0611862364439684,0.0045521488820457895
Chaco,departamento General Güemes,68429,64510,3714,205,34694,32731,1868,95,33735,31779,1846,110,0.9427289599438834,0.05427523418433705,0.0029958058717795086,0.9434196114601948,0.05384216291001326,0.002738225629791895,0.9420186749666518,0.054720616570327556,0.0032607084630206016
Chaco,departamento Independencia,21948,20524,1328,96,11362,10637,680,45,10586,9887,648,51,0.9351193730636049,0.060506652086750504,0.004373974849644614,0.9361908114768527,0.05984861820102095,0.003960570322126386,0.933969393538636,0.061212922728131496,0.004817683733232572
Chaco,departamento Libertad,13775,12666,1053,56,7018,6464,525,29,6757,6202,528,27,0.919491833030853,0.07644283121597097,0.004065335753176044,0.9210601310914791,0.07480763750356227,0.004132231404958678,0.9178629569335504,0.07814118691727098,0.003995856149178629
Chaco,departamento Libertador General San Martín,65304,61244,3744,316,33088,30984,1959,145,32216,30260,1785,171,0.9378292294499572,0.05733186328555678,0.004838907264486096,0.936411992263056,0.059205754352030945,0.004382253384912959,0.9392848274149491,0.05540725105537621,0.005307921529674696
Chaco,departamento Maipú,26354,25082,1223,49,13368,12698,640,30,12986,12384,583,19,0.9517340821127722,0.04640661759125749,0.0018593002959702513,0.9498803111909037,0.047875523638539794,0.002244165170556553,0.9536423841059603,0.04489450177113815,0.0014631141229015864
Chaco,departamento Mayor Luis J. Fontana,59798,55850,3771,177,31056,28978,1987,91,28742,26872,1784,86,0.9339777250075253,0.0630623097762467,0.0029599652162279676,0.9330886141164348,0.06398119526017516,0.002930190623390005,0.9349384176466495,0.06206944541089694,0.002992136942453552
Chaco,departamento 9 de Julio,30223,27526,2573,124,15455,14106,1295,54,14768,13420,1278,70,0.9107633259438176,0.08513383846739238,0.004102835588789994,0.9127143319314138,0.08379165318667098,0.0034940148819152376,0.9087215601300108,0.08653846153846154,0.004739978331527627
Chaco,departamento O'Higgins,21544,20546,944,54,10997,10485,487,25,10547,10061,457,29,0.9536761975492016,0.043817304121797254,0.002506498329001114,0.9534418477766664,0.044284804946803674,0.0022733472765299628,0.9539205461268607,0.043329856831326445,0.002749597041812838
Chaco,departamento Presidencia de la Plaza,13938,13120,783,35,7120,6704,403,13,6818,6416,380,22,0.9413115224565934,0.056177356866121395,0.00251112067728512,0.9415730337078652,0.05660112359550562,0.0018258426966292136,0.9410384276914051,0.05573481959518921,0.0032267527134056907
Chaco,departamento 1° de Mayo,14265,12841,1318,106,7203,6488,670,45,7062,6353,648,61,0.9001752541184718,0.09239397125832458,0.007430774623203645,0.900735804525892,0.09301679855615716,0.006247396917950854,0.8996035117530444,0.09175870858113849,0.008637779665817049
Chaco,departamento Quitilipi,32430,30936,1409,85,16591,15828,723,40,15839,15108,686,45,0.953931544865865,0.043447425223558434,0.0026210299105766267,0.9540112108974745,0.04357784340907721,0.0024109456934482553,0.9538480964707368,0.04331081507670939,0.002841088452553823
Chaco,departamento San Fernando,413764,367012,43315,3437,217228,192179,23163,1886,196536,174833,20152,1551,0.8870080528997206,0.10468527953132703,0.008306667568952349,0.8846879776087797,0.10662990038116633,0.008682122010053953,0.8895723938616844,0.10253592217201937,0.007891683966296251
Chaco,departamento San Lorenzo,16045,15207,807,31,8199,7773,409,17,7846,7434,398,14,0.9477718915550015,0.05029604238080399,0.001932066064194453,0.9480424442005122,0.049884132211245276,0.0020734235882424686,0.9474891664542442,0.05072648483303594,0.0017843487127198571
Chaco,departamento Sargento Cabral,18696,17540,1115,41,9481,8877,579,25,9215,8663,536,16,0.9381685922122379,0.05963842533162174,0.0021929824561403508,0.9362936399114018,0.06106950743592448,0.0026368526526737686,0.9400976668475312,0.05816603364080304,0.0017362995116657625
Chaco,departamento Tapenagá,4051,3722,309,20,1995,1806,177,12,2056,1916,132,8,0.9187854850654159,0.07627746235497408,0.004937052579609973,0.9052631578947369,0.0887218045112782,0.006015037593984963,0.9319066147859922,0.06420233463035019,0.0038910505836575876
Chaco,departamento 25 de Mayo,32606,31157,1391,58,16473,15734,715,24,16133,15423,676,34,0.9555603263203092,0.042660859964423724,0.0017788137152671287,0.9551387118314818,0.04340435864748376,0.0014569295210344199,0.9559908262567408,0.041901692183722805,0.002107481559536354
Chubut,departamento Biedma,102806,58143,38084,6579,52089,29432,19239,3418,50717,28711,18845,3161,0.5655603758535495,0.3704453047487501,0.06399431939770052,0.5650329244178234,0.3693486148707021,0.06561846071147459,0.5661020959441607,0.3715716623617328,0.06232624169410651
Chubut,departamento Cushamen,28099,16230,11086,783,14195,8204,5568,423,13904,8026,5518,360,0.5776006263568099,0.39453361329584685,0.02786576034734332,0.5779499823881649,0.3922507925325819,0.02979922507925326,0.5772439585730725,0.3968642117376295,0.025891829689298044
Chubut,departamento Escalante,214829,149074,50907,14848,109129,75804,24984,8341,105700,73270,25923,6507,0.6939193498084523,0.23696521419361447,0.06911543599793324,0.6946274592454801,0.22894006176176818,0.0764324789927517,0.6931882686849574,0.2452507095553453,0.06156102175969726
Chubut,departamento Florentino Ameghino,1782,1454,288,40,855,712,127,16,927,742,161,24,0.8159371492704826,0.16161616161616163,0.02244668911335578,0.8327485380116959,0.14853801169590644,0.01871345029239766,0.8004314994606256,0.17367853290183388,0.025889967637540454
Chubut,departamento Futaleufú,49965,38781,10107,1077,26001,20232,5192,577,23964,18549,4915,500,0.7761633143200241,0.20228159711798258,0.021555088561993396,0.7781239183108342,0.19968462751432636,0.02219145417483943,0.7740360540811216,0.20509931564012684,0.02086463027875146
Chubut,departamento Gaiman,12505,10427,1625,453,6299,5259,817,223,6206,5168,808,230,0.8338264694122351,0.12994802079168333,0.036225509796081565,0.8348944276869344,0.12970312748055246,0.0354024448325131,0.8327425072510474,0.13019658395101516,0.03706090879793748
Chubut,departamento Gastre,1181,1038,132,11,514,442,68,4,667,596,64,7,0.8789161727349704,0.1117696867061812,0.009314140558848433,0.8599221789883269,0.13229571984435798,0.007782101167315175,0.8935532233883059,0.095952023988006,0.010494752623688156
Chubut,departamento Languiñeo,2862,2642,186,34,1370,1261,92,17,1492,1381,94,17,0.923130677847659,0.0649895178197065,0.011879804332634521,0.9204379562043795,0.06715328467153285,0.012408759124087591,0.925603217158177,0.06300268096514745,0.011394101876675604
Chubut,departamento Mártires,744,661,77,6,313,275,36,2,431,386,41,4,0.8884408602150538,0.10349462365591398,0.008064516129032258,0.8785942492012779,0.11501597444089456,0.006389776357827476,0.8955916473317865,0.0951276102088167,0.009280742459396751
Chubut,departamento Paso de Indios,1882,1760,102,20,868,822,41,5,1014,938,61,15,0.9351753453772582,0.05419766206163656,0.010626992561105207,0.9470046082949308,0.04723502304147465,0.00576036866359447,0.9250493096646942,0.0601577909270217,0.014792899408284023
Chubut,departamento Rawson,144420,111095,28840,4485,74709,57615,14745,2349,69711,53480,14095,2136,0.7692494114388588,0.1996953330563634,0.03105525550477773,0.7711922258362446,0.19736577922338674,0.03144199494036863,0.7671673050164249,0.20219190658576122,0.030640788397813833
Chubut,departamento Río Senguer,6347,5003,1197,147,3063,2427,565,71,3284,2576,632,76,0.7882464156294312,0.1885930360800378,0.02316054829053096,0.7923604309500489,0.18445968005223637,0.02317988899771466,0.784409257003654,0.19244823386114496,0.023142509135200974
Chubut,departamento Sarmiento,14477,10866,3204,407,7144,5391,1539,214,7333,5475,1665,193,0.7505698694480901,0.22131657111279962,0.028113559439110314,0.754619260918253,0.2154255319148936,0.029955207166853303,0.7466248465839357,0.22705577526251194,0.026319378153552436
Chubut,departamento Tehuelches,5947,5306,566,75,2870,2554,277,39,3077,2752,289,36,0.8922145619640155,0.0951740373297461,0.01261140070623844,0.8898954703832752,0.09651567944250872,0.013588850174216028,0.894377640558986,0.09392265193370165,0.011699707507312317
Chubut,departamento Telsen,1608,1400,197,11,743,625,110,8,865,775,87,3,0.8706467661691543,0.12251243781094527,0.006840796019900498,0.8411843876177658,0.1480484522207268,0.010767160161507403,0.8959537572254336,0.10057803468208093,0.003468208092485549
Córdoba,departamento Calamuchita,75462,52545,21130,1787,38152,26525,10722,905,37310,26020,10408,882,0.6963107259282818,0.28000848108982,0.023680792981898173,0.695245334451667,0.2810337596980499,0.023720905850283077,0.697400160814795,0.27896006432591797,0.023639774859287054
Córdoba,departamento Capital,1498060,1249387,207993,40680,785740,650920,113398,21422,712320,598467,94595,19258,0.8340033109488272,0.13884156842850087,0.027155120622671988,0.8284165245501056,0.144320004072594,0.02726347137730038,0.8401659366576819,0.13279846136567836,0.027035601976639713
Córdoba,departamento Colón,294511,250171,40722,3618,150921,127590,21379,1952,143590,122581,19343,1666,0.8494453517865207,0.1382698778653429,0.012284770348136402,0.8454091875882084,0.14165689334154954,0.012933919070242047,0.8536875827007452,0.13470993801796782,0.011602479281286998
Córdoba,departamento Cruz del Eje,64748,59018,5338,392,33363,30314,2859,190,31385,28704,2479,202,0.9115030580095138,0.08244270093284735,0.006054241057638846,0.9086113359110392,0.08569373257800557,0.00569493151095525,0.9145770272423132,0.07898677712282938,0.006436195634857416
Córdoba,departamento General Roca,36064,29837,6015,212,17921,14804,3001,116,18143,15033,3014,96,0.8273347382431233,0.16678682342502218,0.005878438331854481,0.826069973773785,0.16745717314881983,0.006472853077395235,0.828584026897426,0.1661246761836521,0.005291296918921899
Córdoba,departamento General San Martín,152397,132436,17775,2186,78538,68341,9115,1082,73859,64095,8660,1104,0.8690197313595412,0.11663615425500502,0.014344114385453782,0.8701647610074105,0.11605846851205785,0.013776770480531718,0.8678021635819603,0.11725043664279235,0.01494739977524743
Córdoba,departamento Ischilín,36023,33538,2324,161,18564,17248,1227,89,17459,16290,1097,72,0.9310162951447686,0.06451433806179385,0.004469366793437526,0.9291101055806938,0.06609566903684551,0.004794225382460677,0.9330431296179621,0.06283292284781489,0.004123947534223037
Córdoba,departamento Juárez Celman,68317,59503,8305,509,34544,30202,4063,279,33773,29301,4242,230,0.8709837961268792,0.12156564251943147,0.0074505613536894185,0.8743052339045855,0.11761811023622047,0.008076655859194072,0.867586533621532,0.12560329257098865,0.006810173807479347
Córdoba,departamento Marcos Juárez,107286,89121,17308,857,54973,45283,9246,444,52313,43838,8062,413,0.8306862032324814,0.1613258020617788,0.007987994705739798,0.8237316500827679,0.16819165772288214,0.008076692194349954,0.8379943799820312,0.1541108328713704,0.00789478714659836
Córdoba,departamento Minas,4855,4648,200,7,2389,2285,104,0,2466,2363,96,7,0.9573635427394439,0.0411946446961895,0.0014418125643666324,0.9564671410632064,0.043532858936793636,0.0,0.9582319545823196,0.038929440389294405,0.00283860502838605
Córdoba,departamento Pocho,5070,4770,270,30,2507,2349,140,18,2563,2421,130,12,0.9408284023668639,0.05325443786982249,0.005917159763313609,0.9369764658954927,0.05584363781412046,0.007179896290386917,0.944596176355833,0.05072181037846274,0.0046820132657042525
Córdoba,departamento Presidente Roque Sáenz Peña,37551,32398,4947,206,18965,16383,2477,105,18586,16015,2470,101,0.8627732949854864,0.13174083246784374,0.005485872546669862,0.8638544687582389,0.1306090166095439,0.005536514632217242,0.8616700742494351,0.1328957279672872,0.005434197783277736
Córdoba,departamento Punilla,219494,162457,53202,3835,114576,83865,28708,2003,104918,78592,24494,1832,0.7401432385395501,0.24238475766991352,0.017472003790536414,0.7319595726853791,0.25055858120374247,0.017481846110878368,0.7490802340875732,0.23345851045578453,0.01746125545664233
Córdoba,departamento Río Cuarto,277979,242918,32326,2735,144090,125524,17191,1375,133889,117394,15135,1360,0.8738717672917738,0.11628935998762496,0.009838872720601197,0.8711499757096259,0.11930737733361094,0.009542646956763134,0.876800932115409,0.11304139996564318,0.010157667918947785
Córdoba,departamento Río Primero,58181,52226,4937,1018,29441,26439,2480,522,28740,25787,2457,496,0.8976469981609116,0.08485588078582355,0.01749712105326481,0.8980333548452838,0.08423626914846642,0.017730376006249788,0.8972512178148921,0.08549060542797494,0.017258176757132915
Córdoba,departamento Río Seco,15275,14091,1128,56,7632,7008,600,24,7643,7083,528,32,0.9224877250409166,0.07384615384615385,0.0036661211129296236,0.9182389937106918,0.07861635220125786,0.0031446540880503146,0.9267303414889442,0.06908282088185268,0.004186837629203193
Córdoba,departamento Río Segundo,113311,104288,8377,646,58357,53712,4310,335,54954,50576,4067,311,0.9203696022451483,0.07392927429817052,0.005701123456681169,0.9204037219185359,0.07385574995287626,0.0057405281285878304,0.9203333697274084,0.07400735160315901,0.005659278669432616
Córdoba,departamento San Alberto,42029,34292,7346,391,21507,17366,3935,206,20522,16926,3411,185,0.8159128220990268,0.17478407766066287,0.009303100240310261,0.8074580369182127,0.18296368624168874,0.009578276840098572,0.824773413897281,0.16621187018809083,0.009014715914628204
Córdoba,departamento San Javier,62700,49347,12426,927,32711,25640,6626,445,29989,23707,5800,482,0.7870334928229665,0.19818181818181818,0.01478468899521531,0.7838341842193758,0.20256182935403994,0.013603986426584329,0.7905231918370069,0.19340424822434893,0.01607255993864417
Córdoba,departamento San Justo,228951,195159,32482,1310,116909,99503,16717,689,112042,95656,15765,621,0.8524050997811758,0.14187315189713082,0.005721748321693288,0.851114969762807,0.14299155753620338,0.005893472700989659,0.8537512718444868,0.14070616376001857,0.005542564395494547
Córdoba,departamento Santa María,139012,118387,18846,1779,71126,60367,9822,937,67886,58020,9024,842,0.8516315138261445,0.13557102983915056,0.012797456334704917,0.8487332339791356,0.13809296178612604,0.013173804234738351,0.8546681200836697,0.1329287334649265,0.012403146451403824
Córdoba,departamento Sobremonte,4381,4084,279,18,2214,2061,143,10,2167,2023,136,8,0.9322072586167541,0.06368409039032184,0.00410865099292399,0.9308943089430894,0.06458897922312556,0.004516711833785004,0.9335486848177204,0.06275957544993079,0.0036917397323488694
Córdoba,departamento Tercero Arriba,120207,108438,10551,1218,62095,56031,5453,611,58112,52407,5098,607,0.9020938880431256,0.0877735905562904,0.010132521400583993,0.9023431838312264,0.08781705451324583,0.00983976165552782,0.901827505506608,0.0877271475770925,0.01044534691629956
Córdoba,departamento Totoral,22473,20168,2137,168,11288,10151,1058,79,11185,10017,1079,89,0.8974324745249855,0.0950918880434299,0.007475637431584568,0.8992735648476258,0.09372785258681786,0.006998582565556343,0.8955744300402324,0.09646848457755923,0.007957085382208315
Córdoba,departamento Tulumba,14092,12895,1148,49,7073,6465,584,24,7019,6430,564,25,0.915058189043429,0.08146466080045416,0.003477150156116946,0.9140393043970026,0.08256751025024742,0.003393185352749894,0.916084912380681,0.08035332668471293,0.0035617609346060694
Córdoba,departamento Unión,113635,100121,12606,908,57653,50717,6466,470,55982,49404,6140,438,0.8810753729044749,0.11093413120957452,0.00799049588595063,0.8796940315334848,0.11215374741990876,0.008152221046606421,0.8824979457682827,0.10967811082133543,0.007823943410381909
Corrientes,departamento Bella Vista,44369,40291,3709,369,22524,20477,1867,180,21845,19814,1842,189,0.9080889810453244,0.08359440149654038,0.008316617458135184,0.909119161782987,0.08288936245782276,0.007991475759190196,0.9070267795834287,0.08432135500114443,0.008651865415426872
Corrientes,departamento Berón de Astrada,2808,2571,197,40,1381,1266,92,23,1427,1305,105,17,0.9155982905982906,0.07015669515669516,0.014245014245014245,0.9167270094134685,0.0666183924692252,0.0166545981173063,0.9145059565522075,0.07358093903293624,0.011913104414856343
Corrientes,departamento Capital,437446,379877,52994,4575,228672,197606,28605,2461,208774,182271,24389,2114,0.8683974707735355,0.1211440954997874,0.010458433726677121,0.8641460257486706,0.12509183459277917,0.010762139658550237,0.8730541159339764,0.11682010211999579,0.010125781946027762
Corrientes,departamento Concepción,26270,23978,2045,247,13121,12038,968,115,13149,11940,1077,132,0.9127521888085268,0.0778454510848877,0.00940236010658546,0.9174605594085816,0.07377486472067678,0.008764575870741559,0.9080538443988136,0.08190736938170202,0.01003878621948437
Corrientes,departamento Curuzú Cuatiá,51489,46394,4812,283,26518,23987,2396,135,24971,22407,2416,148,0.9010468255355513,0.09345685486220358,0.0054963196022451396,0.9045553963345652,0.09035372200015084,0.005090881665283958,0.8973208922349926,0.09675223258980417,0.0059268751752032355
Corrientes,departamento Empedrado,17948,16134,1713,101,9104,8138,913,53,8844,7996,800,48,0.8989302429240027,0.0954423891241364,0.0056273679518609315,0.8938927943760984,0.10028558875219684,0.005821616871704745,0.9041157847127996,0.09045680687471733,0.005427408412483039
Corrientes,departamento Esquina,39168,33488,5241,439,20208,17365,2633,210,18960,16123,2608,229,0.8549836601307189,0.13380821078431374,0.01120812908496732,0.8593131433095804,0.13029493269992082,0.010391923990498812,0.8503691983122363,0.13755274261603376,0.012078059071729957
Corrientes,departamento General Alvear,9051,7745,1183,123,4525,3917,547,61,4526,3828,636,62,0.8557065517622362,0.13070378963650425,0.01358965860125953,0.8656353591160221,0.12088397790055248,0.013480662983425415,0.8457799381352188,0.14052143172779497,0.0136986301369863
Corrientes,departamento General Paz,17016,15125,1722,169,8584,7695,802,87,8432,7430,920,82,0.8888692994828397,0.10119887165021156,0.009931828866948754,0.89643522833178,0.09342963653308481,0.010135135135135136,0.8811669829222012,0.10910815939278938,0.009724857685009488
Corrientes,departamento Goya,106223,96797,8828,598,55144,50321,4522,301,51079,46476,4306,297,0.9112621560302383,0.08310817807819398,0.00562966589156774,0.9125380821122878,0.08200348179312346,0.005458436094588713,0.9098846884238141,0.08430078897394233,0.005814522602243583
Corrientes,departamento Itatí,11946,10511,1095,340,6016,5281,566,169,5930,5230,529,171,0.8798761091578771,0.0916624811652436,0.02846140967687929,0.8778257978723404,0.09408244680851063,0.028091755319148936,0.8819561551433389,0.08920741989881956,0.028836424957841483
Corrientes,departamento Ituzaingó,38767,28888,9187,692,19575,14672,4522,381,19192,14216,4665,311,0.7451698609642221,0.23697990558980575,0.01785023344597209,0.7495274584929758,0.2310089399744572,0.01946360153256705,0.7407253022092538,0.2430700291788245,0.016204668611921633
Corrientes,departamento Lavalle,40406,36131,3462,813,20270,18145,1750,375,20136,17986,1712,438,0.8941988813542543,0.0856803445032916,0.02012077414245409,0.8951652688702516,0.0863344844597928,0.0185002466699556,0.8932260627731426,0.08502185141040922,0.021752085816448153
Corrientes,departamento Mburucuyá,11541,10504,968,69,5849,5343,474,32,5692,5161,494,37,0.9101464344510874,0.08387488085954424,0.005978684689368339,0.9134894853821166,0.08103949393058643,0.005471020687296974,0.9067111735769501,0.08678847505270555,0.0065003513703443426
Corrientes,departamento Mercedes,49807,44599,4890,318,25508,22880,2468,160,24299,21719,2422,158,0.8954363844439537,0.09817897082739374,0.006384644728652599,0.8969734985102713,0.09675395954210443,0.006272541947624275,0.8938227910613605,0.09967488374007161,0.0065023251985678425
Corrientes,departamento Monte Caseros,45602,35616,9459,527,23130,18050,4802,278,22472,17566,4657,249,0.7810183763870006,0.20742511293364327,0.01155651067935617,0.7803718115002162,0.2076091655858193,0.012019022913964549,0.781683873264507,0.20723567105731577,0.011080455678177288
Corrientes,departamento Paso de los Libres,56778,49442,6460,876,29454,25733,3228,493,27324,23709,3232,383,0.8707950262425588,0.11377646271443165,0.015428511043009616,0.873667413594079,0.10959462212263191,0.016737964283289195,0.8676987263943786,0.11828429219733567,0.014016981408285755
Corrientes,departamento Saladas,29126,25751,3117,258,14884,13162,1586,136,14242,12589,1531,122,0.8841241502437684,0.10701778479708851,0.008858064959143033,0.8843052942757323,0.10655737704918032,0.009137328675087342,0.8839348406122736,0.10749894677713805,0.008566212610588401
Corrientes,departamento San Cosme,19679,16115,3254,310,9769,8071,1527,171,9910,8044,1727,139,0.8188932364449413,0.16535393058590375,0.015752832969154938,0.8261848705087522,0.1563107789947794,0.01750435049646842,0.8117053481331988,0.17426841574167506,0.014026236125126134
Corrientes,departamento San Luis del Palmar,21381,19120,2025,236,10912,9774,1020,118,10469,9346,1005,118,0.8942519058977597,0.09471025677002946,0.011037837332210842,0.8957111436950147,0.09347507331378299,0.010813782991202347,0.8927309198586303,0.09599770751743242,0.01127137262393734
Corrientes,departamento San Martín,15164,13572,1481,111,7795,6997,740,58,7369,6575,741,53,0.8950145080453706,0.09766552360854656,0.007319968346082828,0.8976266837716484,0.0949326491340603,0.007440667094291213,0.8922513231103271,0.10055638485547565,0.007192292034197313
Corrientes,departamento San Miguel,12700,11659,962,79,6373,5834,507,32,6327,5825,455,47,0.9180314960629922,0.07574803149606299,0.006220472440944882,0.9154244468852973,0.07955436999843088,0.005021183116271772,0.920657499604868,0.07191401928244033,0.007428481112691639
Corrientes,departamento San Roque,22682,20632,1891,159,11466,10478,904,84,11216,10154,987,75,0.9096199629662287,0.08337007318578608,0.0070099638479851865,0.9138321995464853,0.07884179312750741,0.007326007326007326,0.9053138373751783,0.08799928673323823,0.006686875891583452
Corrientes,departamento Santo Tomé,71922,57976,12574,1372,36837,29610,6415,812,35085,28366,6159,560,0.8060954923389227,0.17482828619893773,0.01907622146213954,0.8038113852919618,0.17414556017048077,0.02204305453755735,0.808493658258515,0.1755451047456178,0.01596123699586718
Corrientes,departamento Sauce,10382,9425,908,49,5264,4782,460,22,5118,4643,448,27,0.9078212290502793,0.08745906376420728,0.004719707185513389,0.9084346504559271,0.08738601823708207,0.004179331306990881,0.9071903087143416,0.08753419304415787,0.005275498241500586
Entre Ríos,departamento Colón,74890,60316,13178,1396,38151,30790,6638,723,36739,29526,6540,673,0.8053945787154493,0.175964748297503,0.01864067298704767,0.8070561715289245,0.173992818012634,0.018951010458441456,0.8036691254525165,0.17801246631644846,0.01831840823103514
Entre Ríos,departamento Concordia,197603,176427,19098,2078,101625,90846,9678,1101,95978,85581,9420,977,0.8928356350865119,0.09664833023790124,0.01051603467558691,0.8939335793357933,0.09523247232472325,0.010833948339483394,0.8916730917501927,0.09814749213361396,0.010179416116193295
Entre Ríos,departamento Diamante,52312,43137,7583,1592,26807,21933,3995,879,25505,21204,3588,713,0.8246100321150023,0.14495717999694144,0.030432787888056277,0.8181818181818182,0.1490282388928265,0.032789942925355316,0.831366398745344,0.14067829837286808,0.027955302881787884
Entre Ríos,departamento Federación,78264,67280,10288,696,39250,33855,5063,332,39014,33425,5225,364,0.8596545027087805,0.1314525196769907,0.008892977614228765,0.8625477707006369,0.12899363057324842,0.00845859872611465,0.8567437330189163,0.13392628287281488,0.009329984108268827
Entre Ríos,departamento Federal,29436,27036,2283,117,14912,13719,1132,61,14524,13317,1151,56,0.918467183041174,0.07755809213208316,0.003974724826742764,0.9199973175965666,0.07591201716738197,0.004090665236051502,0.9168961718534839,0.07924814100798679,0.003855687138529331
Entre Ríos,departamento Feliciano,16717,15204,1411,102,8544,7780,712,52,8173,7424,699,50,0.9094933301429682,0.08440509660824311,0.006101573248788658,0.9105805243445693,0.08333333333333333,0.006086142322097378,0.9083567845344427,0.0855255108283372,0.006117704637220115
Entre Ríos,departamento Gualeguay,56796,50753,5681,362,29197,26130,2885,182,27599,24623,2796,180,0.8936016620888795,0.1000246496232129,0.006373688287907599,0.8949549611261431,0.09881152173168477,0.006233517142172141,0.8921700061596435,0.101308018406464,0.006521975433892532
Entre Ríos,departamento Gualeguaychú,125176,107425,15996,1755,64445,55337,8221,887,60731,52088,7775,868,0.8581916661340833,0.1277880743912571,0.01402025947465968,0.8586701838777252,0.12756614167119248,0.013763674451082319,0.8576838846717492,0.12802357939108527,0.014292535937165533
Entre Ríos,departamento Islas del Ibicuy,13984,10920,2955,109,6934,5430,1449,55,7050,5490,1506,54,0.7808924485125858,0.2113129290617849,0.007794622425629291,0.7830977790597058,0.2089702913181425,0.007931929622151716,0.7787234042553192,0.21361702127659574,0.007659574468085106
Entre Ríos,departamento La Paz,75271,68203,6781,287,38524,34881,3492,151,36747,33322,3289,136,0.9060992945490295,0.09008781602476386,0.00381288942620664,0.9054355726300488,0.0906447928564012,0.003919634513549995,0.9067951125261926,0.08950390508068685,0.003700982393120527
Entre Ríos,departamento Nogoyá,42954,38487,3930,537,21933,19583,2055,295,21021,18904,1875,242,0.8960050286352843,0.0914932253107976,0.012501746053918145,0.8928555145214973,0.09369443304609493,0.013450052432407787,0.8992911850054707,0.08919651776794633,0.011512297226582941
Entre Ríos,departamento Paraná,388716,347973,38307,2436,202553,181266,20056,1231,186163,166707,18251,1205,0.8951856882659834,0.09854752569999692,0.006266786034019696,0.8949065182939774,0.09901605999417436,0.006077421711848257,0.895489436676461,0.09803774111934165,0.006472822204197397
Entre Ríos,departamento San Salvador,20786,19013,1628,145,10530,9613,845,72,10256,9400,783,73,0.9147022034061387,0.07832194746463966,0.006975849129221592,0.9129154795821462,0.08024691358024691,0.006837606837606838,0.9165366614664586,0.07634555382215288,0.007117784711388455
Entre Ríos,departamento Tala,31091,27141,3552,398,16074,14022,1838,214,15017,13119,1714,184,0.8729535878550063,0.11424527998456145,0.01280113216043228,0.8723404255319149,0.11434614906059475,0.013313425407490358,0.8736099087700606,0.11413731104747953,0.012252780182459878
Entre Ríos,departamento Uruguay,115516,99917,13996,1603,59501,51418,7258,825,56015,48499,6738,778,0.864962429447003,0.12116070501056131,0.01387686554243568,0.8641535436379221,0.1219811431740643,0.013865313188013647,0.8658216549138623,0.12028920824779077,0.013889136838346871
Entre Ríos,departamento Victoria,40301,34618,5454,229,20565,17645,2809,111,19736,16973,2645,118,0.8589861293764423,0.13533162948810204,0.0056822411354556955,0.8580111840505713,0.13659129589107707,0.005397520058351568,0.8600020267531414,0.1340190514795298,0.0059789217673287395
Entre Ríos,departamento Villaguay,55284,49609,5163,512,28216,25345,2620,251,27068,24264,2543,261,0.8973482381882643,0.0933904927284567,0.009261269083279068,0.8982492203005387,0.09285511766373689,0.008895662035724412,0.8964090438894635,0.0939485739618738,0.009642382148662627
Formosa,departamento Bermejo,15600,14048,1404,148,7536,6764,680,92,8064,7284,724,56,0.9005128205128206,0.09,0.009487179487179488,0.8975583864118896,0.09023354564755838,0.012208067940552018,0.9032738095238095,0.08978174603174603,0.006944444444444444
Formosa,departamento Formosa,268572,237792,22745,8035,140026,123636,11575,4815,128546,114156,11170,3220,0.8853938608641259,0.08468864959861788,0.029917489537256304,0.8829503092282862,0.08266321968777227,0.03438647108394156,0.8880556376705615,0.08689496367059263,0.02504939865884586
Formosa,departamento Laishi,19275,17149,1676,450,9661,8572,856,233,9614,8577,820,217,0.8897016861219196,0.08695201037613488,0.023346303501945526,0.8872787496118414,0.08860366421695477,0.024117586171203808,0.8921364676513418,0.08529228208862076,0.022571250260037444
Formosa,departamento Matacos,17017,15072,1858,87,8621,7680,902,39,8396,7392,956,48,0.8857025327613562,0.10918493271434448,0.00511253452429923,0.890847929474539,0.1046282333835982,0.004523837141862893,0.8804192472606003,0.11386374464030491,0.005717008099094807
Formosa,departamento Patiño,81600,73761,6781,1058,40691,36842,3310,539,40909,36919,3471,519,0.9039338235294118,0.08310049019607843,0.012965686274509804,0.9054090585141678,0.0813447691135632,0.013246172372269053,0.9024664499254442,0.08484685521523382,0.012686694859321909
Formosa,departamento Pilagás,19089,17401,1026,662,9569,8700,491,378,9520,8701,535,284,0.9115721095919116,0.05374823196605375,0.03467965844203468,0.9091859128435573,0.05131152680530881,0.03950256035113387,0.9139705882352941,0.05619747899159664,0.029831932773109245
Formosa,departamento Pilcomayo,94116,80348,8038,5730,48394,40941,3978,3475,45722,39407,4060,2255,0.8537124399676994,0.08540524459178035,0.06088231544052021,0.8459933049551597,0.08220027276108609,0.07180642228375418,0.8618826822973623,0.088797515419273,0.04931980228336468
Formosa,departamento Pirané,72560,63031,8649,880,36854,31919,4475,460,35706,31112,4174,420,0.8686742006615215,0.11919790518191842,0.012127894156560088,0.8660932327562816,0.12142508275899495,0.012481684484723504,0.8713381504509046,0.11689912059597826,0.011762728953117123
Formosa,departamento Ramón Lista,17678,16849,771,58,8864,8449,389,26,8814,8400,382,32,0.953105554927028,0.0436135309424143,0.0032809141305577554,0.9531814079422383,0.04388537906137184,0.0029332129963898917,0.9530292716133424,0.04334014068527343,0.0036305877013841615
Jujuy,departamento Cochinoca,14998,13619,1123,256,7890,7133,609,148,7108,6486,514,108,0.9080544072543005,0.07487665022002933,0.01706894252567009,0.9040557667934094,0.07718631178707225,0.01875792141951838,0.9124929656724817,0.0723128868880135,0.015194147439504783
Jujuy,departamento Dr. Manuel Belgrano,319469,264212,45003,10254,167292,137521,23868,5903,152177,126691,21135,4351,0.8270348609724261,0.14086812804998294,0.03209701097759094,0.8220416995433135,0.14267269205939315,0.035285608397293354,0.8325239687994901,0.13888432548939722,0.028591705711112716
Jujuy,departamento El Carmen,122259,91153,24013,7093,62150,46066,12253,3831,60109,45087,11760,3262,0.7455729230567892,0.19641089817518548,0.058016178768025256,0.741206757843926,0.19715205148833467,0.06164119066773934,0.7500873413299173,0.1956445790147898,0.054268079655292886
Jujuy,departamento Humahuaca,20877,16995,3260,622,10965,8866,1766,333,9912,8129,1494,289,0.8140537433539302,0.15615270393255737,0.02979355271351248,0.8085727314181487,0.1610579115367077,0.03036935704514364,0.8201170298627926,0.15072639225181597,0.029156577885391444
Jujuy,departamento Ledesma,94132,76766,13563,3803,47656,38772,6921,1963,46476,37994,6642,1840,0.8155143840564314,0.144084902052437,0.040400713891131604,0.8135806614067483,0.1452283028369985,0.041191035756253144,0.8174972028573888,0.1429124709527498,0.039590326189861434
Jujuy,departamento Palpalá,65522,54812,9212,1498,33531,27902,4746,883,31991,26910,4466,615,0.8365434510546076,0.14059399896218064,0.022862549983211744,0.8321254958098476,0.1415406638632907,0.02633384032686171,0.8411740802100591,0.1396017629958426,0.019224156794098342
Jujuy,departamento Rinconada,1797,1639,118,40,894,811,65,18,903,828,53,22,0.9120756816917084,0.06566499721758487,0.022259321090706732,0.9071588366890381,0.07270693512304251,0.020134228187919462,0.9169435215946844,0.058693244739756366,0.024363233665559248
Jujuy,departamento San Antonio,6729,5395,1137,197,3356,2686,557,113,3373,2709,580,84,0.8017536038044286,0.16897012929112795,0.029276266904443453,0.800357568533969,0.1659713945172825,0.03367103694874851,0.8031426030240142,0.17195375037059,0.02490364660539579
Jujuy,departamento San Pedro,88237,74342,11512,2383,45194,37895,6029,1270,43043,36447,5483,1113,0.842526377823362,0.13046681097498783,0.0270068112016501,0.8384962605655618,0.13340266407045184,0.02810107536398637,0.8467578932695212,0.12738424366331344,0.025857863067165393
Jujuy,departamento Santa Bárbara,20497,17081,2728,688,10069,8446,1293,330,10428,8635,1435,358,0.8333414646045763,0.13309264770454213,0.03356588769088159,0.8388121958486443,0.12841394378786375,0.032773860363491905,0.8280590717299579,0.1376102800153433,0.034330648254698885
Jujuy,departamento Santa Catalina,2641,1873,449,319,1382,945,255,182,1259,928,194,137,0.709201060204468,0.17001135933358577,0.12078758046194624,0.6837916063675832,0.18451519536903038,0.1316931982633864,0.7370929308975377,0.15409054805401112,0.10881652104845115
Jujuy,departamento Susques,3966,3573,349,44,2012,1811,181,20,1954,1762,168,24,0.9009077155824509,0.08799798285426122,0.011094301563287948,0.9000994035785288,0.08996023856858847,0.009940357852882704,0.901740020470829,0.08597748208802457,0.012282497441146366
Jujuy,departamento Tilcara,14621,12450,1645,526,7549,6393,878,278,7072,6057,767,248,0.8515149442582587,0.11250940428151289,0.035975651460228436,0.8468671347198304,0.1163067956020665,0.03682606967810306,0.8564762443438914,0.10845588235294118,0.03506787330316742
Jujuy,departamento Tumbaya,5298,4559,620,119,2719,2329,323,67,2579,2230,297,52,0.8605134012835032,0.11702529256323141,0.022461306153265383,0.8565649135711658,0.11879367414490621,0.024641412283927914,0.8646762310973245,0.11516091508336565,0.02016285381930981
Jujuy,departamento Valle Grande,2490,2171,242,77,1244,1063,139,42,1246,1108,103,35,0.8718875502008032,0.09718875502008033,0.030923694779116467,0.8545016077170418,0.11173633440514469,0.03376205787781351,0.8892455858747994,0.0826645264847512,0.028089887640449437
Jujuy,departamento Yavi,25831,19041,4392,2398,13716,9987,2260,1469,12115,9054,2132,929,0.7371375479075529,0.170028260617088,0.09283419147535907,0.7281277340332458,0.1647710702828813,0.10710119568387284,0.7473380107304994,0.17598018984729674,0.07668179942220388
La Pampa,departamento Atreucó,11053,8475,2487,91,5524,4208,1261,55,5529,4267,1226,36,0.7667601556138605,0.22500678548810277,0.008233058898036731,0.7617668356263577,0.2282766111513396,0.00995655322230268,0.7717489600289383,0.22173991680231506,0.0065111231687466084
La Pampa,departamento Caleu Caleu,2611,774,1810,27,1297,396,890,11,1314,378,920,16,0.29643814630409804,0.6932209881271544,0.010340865568747606,0.3053199691595991,0.6861989205859677,0.008481110254433308,0.2876712328767123,0.700152207001522,0.0121765601217656
La Pampa,departamento Capital,118504,95816,21602,1086,61648,49872,11200,576,56856,45944,10402,510,0.8085465469520016,0.18228920542766489,0.009164247620333492,0.8089800155722814,0.18167661562418894,0.009343368803529718,0.8080765442521458,0.1829534261995216,0.00897002954833263
La Pampa,departamento Catriló,8225,6265,1896,64,4100,3107,954,39,4125,3158,942,25,0.7617021276595745,0.23051671732522797,0.007781155015197569,0.7578048780487805,0.2326829268292683,0.00951219512195122,0.7655757575757576,0.22836363636363635,0.006060606060606061
La Pampa,departamento Chalileo,2868,2126,729,13,1456,1060,390,6,1412,1066,339,7,0.7412831241283124,0.25418410041841005,0.004532775453277545,0.728021978021978,0.26785714285714285,0.004120879120879121,0.7549575070821529,0.24008498583569404,0.004957507082152974
La Pampa,departamento Chapaleufú,12277,8829,3366,82,6119,4386,1697,36,6158,4443,1669,46,0.7191496293882871,0.2741712144660748,0.006679156145638185,0.7167837882006863,0.2773328975322765,0.005883314267037098,0.7215004871711594,0.27102955505034104,0.007469957778499512
La Pampa,departamento Chical Co,1461,1001,458,2,711,484,225,2,750,517,233,0,0.6851471594798083,0.3134839151266256,0.0013689253935660506,0.680731364275668,0.31645569620253167,0.0028129395218002813,0.6893333333333334,0.31066666666666665,0.0
La Pampa,departamento Conhelo,15094,12892,2124,78,7591,6495,1046,50,7503,6397,1078,28,0.8541142175698954,0.14071816615873858,0.005167616271366106,0.8556184955868792,0.13779475694901858,0.006586747464102227,0.8525922964147674,0.1436758629881381,0.0037318405970944955
La Pampa,departamento Curacó,1103,668,403,32,515,329,173,13,588,339,230,19,0.6056210335448776,0.3653671804170444,0.02901178603807797,0.6388349514563106,0.3359223300970874,0.02524271844660194,0.576530612244898,0.391156462585034,0.03231292517006803
La Pampa,departamento Guatraché,9397,6792,2222,383,4661,3318,1153,190,4736,3474,1069,193,0.7227838671916569,0.23645844418431414,0.04075768862402895,0.711864406779661,0.24737180862475863,0.040763784595580346,0.7335304054054054,0.2257179054054054,0.040751689189189186
La Pampa,departamento Hucal,7713,5991,1672,50,3840,2914,895,31,3873,3077,777,19,0.7767405678724232,0.2167768702191106,0.006482561908466226,0.7588541666666667,0.23307291666666666,0.008072916666666667,0.7944745675187194,0.20061967467079783,0.0049057578104828295
La Pampa,departamento Lihuel Calel,428,266,153,9,190,120,65,5,238,146,88,4,0.6214953271028038,0.3574766355140187,0.02102803738317757,0.631578947368421,0.34210526315789475,0.02631578947368421,0.6134453781512605,0.3697478991596639,0.01680672268907563
La Pampa,departamento Limay Mahuida,413,371,41,1,195,172,23,0,218,199,18,1,0.8983050847457628,0.09927360774818401,0.002421307506053269,0.882051282051282,0.11794871794871795,0.0,0.9128440366972477,0.08256880733944955,0.0045871559633027525
La Pampa,departamento Loventué,9243,8133,1063,47,4626,4078,522,26,4617,4055,541,21,0.8799091204154496,0.11500595044898843,0.005084929135562047,0.8815391266753134,0.11284046692607004,0.005620406398616515,0.8782759367554689,0.1171756551873511,0.004548408057179987
La Pampa,departamento Maracó,69067,53290,15108,669,35632,27357,7906,369,33435,25933,7202,300,0.771569635281683,0.21874411803031837,0.00968624668799861,0.7677649303996408,0.22187920969914685,0.010355859901212393,0.7756243457454763,0.21540302078660087,0.008972633467922835
La Pampa,departamento Puelén,11636,6536,4785,315,5791,3208,2431,152,5845,3328,2354,163,0.5617050532829151,0.4112237882433826,0.027071158473702304,0.5539630461060266,0.4197893282680021,0.026247625625971334,0.5693755346449957,0.4027373823781009,0.027887082976903337
La Pampa,departamento Quemú Quemú,8404,6947,1403,54,4144,3406,711,27,4260,3541,692,27,0.8266301761066159,0.16694431223227035,0.006425511661113755,0.821911196911197,0.17157335907335908,0.0065154440154440154,0.8312206572769953,0.1624413145539906,0.006338028169014085
La Pampa,departamento Rancul,11090,8715,2323,52,5466,4294,1150,22,5624,4421,1173,30,0.7858431018935979,0.20946798917944093,0.004688908926961226,0.7855836077570435,0.21039151115989754,0.00402488108305891,0.7860953058321479,0.20857041251778094,0.005334281650071123
La Pampa,departamento Realicó,17356,12964,4288,104,8747,6453,2247,47,8609,6511,2041,57,0.7469463009910118,0.24706153491587923,0.005992164093109011,0.7377386532525437,0.2568880759117412,0.0053732708357151025,0.7563015448948774,0.23707747705889184,0.006620978046230689
La Pampa,departamento Toay,17927,14097,3691,139,8976,7126,1773,77,8951,6971,1918,62,0.786355776203492,0.20589055614436325,0.007753667652144809,0.7938948306595366,0.19752673796791445,0.00857843137254902,0.7787956652887945,0.21427773433135963,0.006926600379845827
La Pampa,departamento Trenel,5637,4676,921,40,2817,2357,440,20,2820,2319,481,20,0.8295192478268583,0.16338477913783928,0.007095973035302466,0.8367057152999645,0.1561945331913383,0.007099751508697196,0.8223404255319149,0.17056737588652482,0.0070921985815602835
La Pampa,departamento Utracán,17686,14753,2770,163,8856,7425,1345,86,8830,7328,1425,77,0.8341626144973425,0.15662105620264616,0.009216329300011308,0.8384146341463414,0.15187443541102078,0.00971093044263776,0.8298980747451868,0.16138165345413363,0.008720271800679502
La Rioja,departamento Arauco,16251,13458,2618,175,8218,6875,1257,86,8033,6583,1361,89,0.8281336533136422,0.16109777859824012,0.010768568088117655,0.8365782428814796,0.15295692382574835,0.010464833292771964,0.8194945848375451,0.1694261172662766,0.011079297896178265
La Rioja,departamento Ángel Vicente Peñaloza,3184,2906,272,6,1590,1448,138,4,1594,1458,134,2,0.9126884422110553,0.08542713567839195,0.0018844221105527637,0.9106918238993711,0.08679245283018867,0.0025157232704402514,0.9146800501882058,0.08406524466750313,0.0012547051442910915
La Rioja,departamento Capital,210507,165746,41579,3182,109219,85573,22003,1643,101288,80173,19576,1539,0.7873657408067191,0.1975183723106595,0.015115886882621481,0.7834992080132578,0.20145762184235344,0.015043170144388798,0.7915350288286865,0.1932706737224548,0.0151942974488587
La Rioja,departamento Castro Barros,5810,4168,1381,261,2960,2078,731,151,2850,2090,650,110,0.7173838209982788,0.23769363166953528,0.04492254733218588,0.702027027027027,0.24695945945945946,0.05101351351351351,0.7333333333333333,0.22807017543859648,0.03859649122807018
La Rioja,departamento Chamical,15630,12904,2661,65,8001,6560,1406,35,7629,6344,1255,30,0.8255918106206014,0.17024952015355085,0.004158669225847729,0.8198975128108986,0.17572803399575054,0.004374453193350831,0.8315637698256653,0.1645038668239612,0.003932363350373574
La Rioja,departamento Chilecito,58681,47141,9838,1702,29976,24163,4932,881,28705,22978,4906,821,0.8033435013036587,0.16765222133228813,0.029004277364053102,0.8060781958900454,0.16453162530024018,0.029390178809714437,0.8004877199094235,0.17091099111653021,0.028601288974046332
La Rioja,departamento Famatina,6984,6019,926,39,3458,2969,470,19,3526,3050,456,20,0.8618270332187858,0.13258877434135166,0.005584192439862543,0.8585887796414112,0.1359167148640833,0.005494505494505495,0.8650028360748724,0.12932501418037437,0.005672149744753261
La Rioja,departamento General Belgrano,7615,6153,1409,53,3883,3147,707,29,3732,3006,702,24,0.80801050558109,0.1850295469468155,0.00695994747209455,0.8104558331187226,0.18207571465361833,0.007468452227659027,0.8054662379421221,0.18810289389067525,0.006430868167202572
La Rioja,departamento General Felipe Varela,11371,10013,1298,60,5627,4930,671,26,5744,5083,627,34,0.8805733884442881,0.11415003078005452,0.005276580775657374,0.8761329305135952,0.11924649013684023,0.004620579349564599,0.8849233983286908,0.10915738161559889,0.005919220055710306
La Rioja,departamento General Juan Facundo Quiroga,4013,3436,550,27,1922,1639,268,15,2091,1797,282,12,0.8562172937951658,0.1370545726389235,0.00672813356591079,0.8527575442247659,0.13943808532778357,0.007804370447450572,0.8593974175035868,0.13486370157819225,0.005738880918220947
La Rioja,departamento General Lamadrid,1885,1637,237,11,970,843,119,8,915,794,118,3,0.8684350132625994,0.12572944297082228,0.005835543766578249,0.8690721649484536,0.12268041237113401,0.008247422680412371,0.8677595628415301,0.12896174863387977,0.003278688524590164
La Rioja,departamento General Ortiz de Ocampo,7347,6184,1128,35,3637,3042,578,17,3710,3142,550,18,0.8417040969103036,0.15353205389955082,0.004763849190145638,0.8364036293648611,0.15892218861699203,0.004674182018146824,0.846900269541779,0.14824797843665768,0.004851752021563342
La Rioja,departamento General San Martín,5017,4213,791,13,2496,2113,377,6,2521,2100,414,7,0.8397448674506677,0.1576639425951764,0.00259118995415587,0.8465544871794872,0.15104166666666666,0.002403846153846154,0.8330027766759223,0.16422054740182468,0.002776675922253074
La Rioja,departamento Independencia,2399,2147,247,5,1190,1051,138,1,1209,1096,109,4,0.8949562317632347,0.10295956648603585,0.0020842017507294707,0.8831932773109243,0.11596638655462185,0.0008403361344537816,0.9065343258891646,0.09015715467328371,0.0033085194375516956
La Rioja,departamento Rosario Vera Peñaloza,15764,12454,3246,64,8011,6311,1661,39,7753,6143,1585,25,0.7900279116975387,0.20591220502410557,0.0040598832783557475,0.7877917862938459,0.20733990762701285,0.004868306079141181,0.7923384496324004,0.20443699213207792,0.0032245582355217334
La Rioja,departamento San Blas de Los Sauces,4306,3654,615,37,2184,1837,325,22,2122,1817,290,15,0.8485833720390153,0.14282396655829074,0.008592661402693916,0.8411172161172161,0.1488095238095238,0.010073260073260074,0.8562676720075401,0.13666352497643733,0.00706880301602262
La Rioja,departamento Sanagasta,2994,2434,531,29,1540,1241,284,15,1454,1193,247,14,0.8129592518370073,0.17735470941883769,0.009686038744154976,0.8058441558441558,0.18441558441558442,0.00974025974025974,0.8204951856946355,0.16987620357634112,0.009628610729023384
La Rioja,departamento Vinchina,2695,2487,200,8,1305,1203,98,4,1390,1284,102,4,0.9228200371057514,0.07421150278293136,0.002968460111317254,0.9218390804597701,0.07509578544061303,0.0030651340996168583,0.9237410071942446,0.07338129496402877,0.0028776978417266188
Mendoza,departamento Capital,123715,95432,21695,6588,66218,50541,12006,3671,57497,44891,9689,2917,0.771385846502041,0.1753627288526048,0.05325142464535424,0.7632516838321907,0.18131021776556222,0.05543809840224712,0.7807537784580065,0.1685131398159904,0.0507330817260031
Mendoza,departamento General Alvear,52379,44739,6815,825,27236,23158,3639,439,25143,21581,3176,386,0.8541400179461235,0.1301093949865404,0.015750587067336147,0.8502716992216185,0.13360992803642238,0.01611837274195917,0.8583303503957364,0.12631746410531758,0.01535218549894603
Mendoza,departamento Godoy Cruz,194557,167662,21636,5259,102772,87650,12021,3101,91785,80012,9615,2158,0.8617628766890937,0.11120648447498677,0.02703063883591955,0.8528587553030008,0.11696765656015257,0.03017358813684661,0.8717328539521708,0.10475567903252166,0.023511467015307513
Mendoza,departamento Guaymallén,320871,269901,37107,13863,166140,138818,19863,7459,154731,131083,17244,6404,0.8411511168039493,0.11564460484119786,0.04320427835485288,0.8355483327314314,0.1195557963163597,0.04489587095220898,0.8471670188908493,0.11144502394478159,0.04138795716436913
Mendoza,departamento Junín,46472,40423,5333,716,23787,20682,2702,403,22685,19741,2631,313,0.8698355999311413,0.11475727319676364,0.015407126872095025,0.8694665153234961,0.11359145751881279,0.016942027157691174,0.8702226140621556,0.11597972228344722,0.013797663654397179
Mendoza,departamento La Paz,12018,10820,1076,122,6094,5447,584,63,5924,5373,492,59,0.9003161923780996,0.08953236811449493,0.010151439507405558,0.8938299967180834,0.09583196586806696,0.010338037413849688,0.9069885212694125,0.08305199189736664,0.009959486833220796
Mendoza,departamento Las Heras,233839,197341,29618,6880,120786,101132,15793,3861,113053,96209,13825,3019,0.8439182514465081,0.1266597958424386,0.029421952711053332,0.8372824665110195,0.13075190833374728,0.03196562515523322,0.8510079343316851,0.12228777652959232,0.026704289138722546
Mendoza,departamento Lavalle,47086,40826,4831,1429,23671,20550,2397,724,23415,20276,2434,705,0.8670517775984369,0.10259949878944909,0.030348723612114003,0.8681509019475308,0.10126314900088716,0.030585949051582104,0.8659406363442238,0.10395045910740978,0.03010890454836643
Mendoza,departamento Luján de Cuyo,171883,141267,23552,7064,88010,72054,12129,3827,83873,69213,11423,3237,0.8218788361850794,0.13702344036350309,0.04109772345141753,0.8187024201795251,0.1378138847858198,0.04348369503465515,0.82521192755714,0.13619400760673875,0.03859406483612128
Mendoza,departamento Maipú,218887,182590,27794,8503,112470,93465,14511,4494,106417,89125,13283,4009,0.8341747111523298,0.12697876073042255,0.03884652811724771,0.8310216057615364,0.12902107228594292,0.03995732195252067,0.8375071652085663,0.12482028247366492,0.037672552317768775
Mendoza,departamento Malargüe,32596,29608,2632,356,16483,14965,1311,207,16113,14643,1321,149,0.9083323107129709,0.0807461038164192,0.01092158547060989,0.90790511436025,0.0795364921434205,0.012558393496329551,0.9087693167008006,0.0819834915906411,0.009247191708558308
Mendoza,departamento Rivadavia,63589,57649,5139,801,32632,29558,2669,405,30957,28091,2470,396,0.906587617355203,0.08081586437905927,0.012596518265737785,0.9057979897033587,0.08179088011767591,0.012411130178965432,0.9074199696353006,0.07978809316148205,0.012791937203217366
Mendoza,departamento San Carlos,39752,33775,3722,2255,20154,17199,1810,1145,19598,16576,1912,1110,0.8496427852686658,0.09363050915677198,0.05672670557456229,0.8533789818398333,0.0898084747444676,0.056812543415699114,0.8458005918971324,0.0975609756097561,0.05663843249311154
Mendoza,departamento San Martín,139406,120153,16619,2634,71860,61795,8704,1361,67546,58358,7915,1273,0.8618926014662209,0.11921294635811945,0.018894452175659583,0.8599359866406903,0.12112440857222377,0.018939604787086,0.8639741805584342,0.11717940366565008,0.018846415775915674
Mendoza,departamento San Rafael,213204,183599,24948,4657,110511,94798,13305,2408,102693,88801,11643,2249,0.8611423800679162,0.11701469015590701,0.021842929776176807,0.8578150591343848,0.12039525477101827,0.02178968609459692,0.8647230093579893,0.11337676375215448,0.021900226889856173
Mendoza,departamento Santa Rosa,19379,17728,1503,148,9616,8763,779,74,9763,8965,724,74,0.9148046854842871,0.077558181536715,0.007637132978997884,0.9112936772046589,0.0810108153078203,0.007695507487520799,0.9182628290484482,0.0741575335450169,0.007579637406534876
Mendoza,departamento Tunuyán,59972,49902,8416,1654,31019,25805,4306,908,28953,24097,4110,746,0.8320883078770093,0.1403321550056693,0.027579537117321418,0.8319094748380025,0.13881814371836615,0.029272381443631323,0.832279901909992,0.14195420163713604,0.025765896452871896
Mendoza,departamento Tupungato,41168,33239,5093,2836,20594,16613,2507,1474,20574,16626,2586,1362,0.8073989506412748,0.12371259230470268,0.06888845705402254,0.8066912693017384,0.1217344857725551,0.07157424492570652,0.8081073199183435,0.12569262175561388,0.06620005832604257
Misiones,departamento Apóstoles,50503,42985,7072,446,25702,21820,3635,247,24801,21165,3437,199,0.8511375561847812,0.14003128527018197,0.00883115854503693,0.8489611703369387,0.14142868259279434,0.009610147070266905,0.8533930083464376,0.13858312164832062,0.008023870005241724
Misiones,departamento Cainguás,59875,55527,3566,782,29720,27576,1738,406,30155,27951,1828,376,0.9273820459290187,0.05955741127348643,0.013060542797494782,0.9278600269179004,0.05847913862718708,0.013660834454912518,0.9269109600397943,0.060620129331785774,0.012468910628419832
Misiones,departamento Candelaria,34945,30537,3460,948,17861,15562,1780,519,17084,14975,1680,429,0.8738589211618257,0.09901273429675204,0.027128344541422236,0.871283802698617,0.09965847376966576,0.02905772353171715,0.8765511589791618,0.09833762584874736,0.025111215172090844
Misiones,departamento Capital,391498,332180,46512,12806,205282,173915,23720,7647,186216,158265,22792,5159,0.8484845388737619,0.11880520462428927,0.03271025650194893,0.8472004364727546,0.11554836761138336,0.03725119591586208,0.8499001159943291,0.12239549770159384,0.027704386304076987
Misiones,departamento Concepción,10303,9271,916,116,5195,4662,470,63,5108,4609,446,53,0.8998349995147045,0.08890614384159953,0.01125885664369601,0.8974013474494706,0.0904716073147257,0.012127045235803657,0.9023101018010963,0.08731401722787784,0.010375880971025842
Misiones,departamento Eldorado,91133,79817,7179,4137,46759,40927,3611,2221,44374,38890,3568,1916,0.8758298311259368,0.07877497723107985,0.045395191642983335,0.8752753480613358,0.07722577471716675,0.04749887722149747,0.8764141163744535,0.08040744580159553,0.04317843782395096
Misiones,departamento General Manuel Belgrano,45456,40855,2943,1658,22653,20293,1432,928,22803,20562,1511,730,0.898781239000352,0.06474392819429778,0.03647483280535023,0.8958195382510042,0.06321458526464487,0.040965876484350856,0.9017234574398105,0.06626321098101128,0.03201333157917818
Misiones,departamento Guaraní,77075,71679,3726,1670,38422,35801,1809,812,38653,35878,1917,858,0.9299902692182939,0.04834252351605579,0.02166720726565034,0.9317838738222893,0.04708240070792775,0.021133725469782937,0.9282073836442191,0.049595115514966495,0.022197500840814427
Misiones,departamento Iguazú,99838,82608,11446,5784,50649,41886,5594,3169,49189,40722,5852,2615,0.8274204210821531,0.11464572607624351,0.0579338528416034,0.8269857252857904,0.11044640565460324,0.0625678690596063,0.8278680192726016,0.11896968834495518,0.05316229238244323
Misiones,departamento Leandro N. Alem,49391,45707,3085,599,25097,23208,1557,332,24294,22499,1528,267,0.9254115122188253,0.062460772205462534,0.012127715575712175,0.9247320396860182,0.06203928756425071,0.013228672749731043,0.9261134436486376,0.06289618835926566,0.010990367992096814
Misiones,departamento Libertador General San Martín,52166,45982,4088,2096,26410,23280,2008,1122,25756,22702,2080,974,0.8814553540620328,0.07836521872483994,0.040179427213127325,0.8814842862552064,0.07603180613404013,0.042483907610753505,0.8814256872185122,0.08075788165864264,0.03781643112284516
Misiones,departamento Montecarlo,38620,33581,2889,2150,19498,16956,1446,1096,19122,16625,1443,1054,0.8695235629207665,0.07480580010357328,0.05567063697566028,0.8696276541183711,0.07416145245666222,0.056210893424966664,0.8694174249555486,0.07546281769689363,0.055119757347557786
Misiones,departamento Oberá,120703,110620,8245,1838,61585,56463,4134,988,59118,54157,4111,850,0.916464379510037,0.06830816135473021,0.015227459135232761,0.9168303970122594,0.06712673540634895,0.016042867581391573,0.9160830880611658,0.06953888832504483,0.01437802361378937
Misiones,departamento San Ignacio,63194,57077,4585,1532,32137,28995,2323,819,31057,28082,2262,713,0.9032028357122511,0.072554356426243,0.02424280786150584,0.9022310732177864,0.0722842829137754,0.02548464386843825,0.9042083910229578,0.07283382168271244,0.02295778729432978
Misiones,departamento San Javier,23080,20848,1713,519,11724,10584,860,280,11356,10264,853,239,0.9032928942807625,0.07422010398613518,0.022487001733102252,0.9027635619242579,0.0733538041624019,0.023882633913340157,0.9038393800634026,0.07511447692849595,0.021046143008101443
Misiones,departamento San Pedro,34690,32195,1879,616,17092,15873,929,290,17598,16322,950,326,0.9280772556932834,0.054165465552032284,0.017757278754684348,0.9286800842499415,0.054352913643809966,0.016967002106248536,0.9274917604273213,0.053983407205364244,0.01852483236731447
Misiones,departamento 25 de Mayo,30877,28101,1446,1330,15350,13930,756,664,15527,14171,690,666,0.9100948926385335,0.04683097451177252,0.04307413284969395,0.9074918566775244,0.04925081433224756,0.043257328990228015,0.9126682552972242,0.04443871964964256,0.04289302505313325
Neuquén,departamento Aluminé,10173,7766,2060,347,5101,3866,1063,172,5072,3900,997,175,0.7633932959795537,0.20249680526884892,0.03410989875159737,0.7578906096843756,0.20839051166437952,0.03371887865124486,0.7689274447949527,0.19656940063091483,0.03450315457413249
Neuquén,departamento Añelo,18150,9508,7526,1116,8776,4759,3478,539,9374,4749,4048,577,0.5238567493112948,0.4146556473829201,0.06148760330578512,0.5422743846855059,0.3963081130355515,0.06141750227894257,0.5066140388308086,0.43183272882440793,0.061553232344783444
Neuquén,departamento Catán Lil,2641,2339,219,83,1262,1118,104,40,1379,1221,115,43,0.8856493752366528,0.08292313517606967,0.03142748958727755,0.8858954041204438,0.08240887480190175,0.03169572107765452,0.8854242204496011,0.08339376359680928,0.03118201595358956
Neuquén,departamento Chos Malal,18289,15457,2534,298,9407,7959,1295,153,8882,7498,1239,145,0.8451528241019192,0.13855322871671497,0.01629394718136585,0.8460720739874561,0.13766344211757203,0.01626448389497183,0.8441792389101553,0.13949560909705022,0.016325151992794416
Neuquén,departamento Collón Curá,4832,3617,1083,132,2425,1816,540,69,2407,1801,543,63,0.7485513245033113,0.22413079470198677,0.027317880794701987,0.7488659793814433,0.22268041237113403,0.02845360824742268,0.7482343165766514,0.2255920232654757,0.026173660157872872
Neuquén,departamento Confluencia,467217,313263,123668,30286,239616,159848,63516,16252,227601,153415,60152,14034,0.6704871612120278,0.26469071116847204,0.06482212761950015,0.6671006944444444,0.2650741185897436,0.06782518696581197,0.6740523987152957,0.2642870637650977,0.06166053751960668
Neuquén,departamento Huiliches,20853,15090,5112,651,10560,7698,2524,338,10293,7392,2588,313,0.7236368867788807,0.24514458351316357,0.03121852970795569,0.7289772727272728,0.2390151515151515,0.032007575757575756,0.7181579714368989,0.25143301272709606,0.03040901583600505
Neuquén,departamento Lácar,39567,22475,14992,2100,20334,11381,7784,1169,19233,11094,7208,931,0.5680238582657265,0.3789016099274648,0.053074531806808704,0.5597029605586702,0.38280712107799747,0.05748991836333235,0.5768210887537045,0.37477252638693914,0.04840638485935631
Neuquén,departamento Loncopué,7696,7110,486,100,3849,3566,234,49,3847,3544,252,51,0.9238565488565489,0.06314968814968815,0.012993762993762994,0.9264744089373863,0.060795011691348405,0.012730579371265264,0.9212373277878867,0.0655055887704705,0.013257083441642838
Neuquén,departamento Los Lagos,15502,6027,8500,975,7754,2974,4258,522,7748,3053,4242,453,0.3887885434137531,0.5483163462778996,0.06289511030834731,0.38354397730203765,0.5491359298426619,0.0673200928553005,0.3940371708828085,0.5474961280330408,0.05846670108415075
Neuquén,departamento Minas,9267,8289,870,108,4516,4053,412,51,4751,4236,458,57,0.894464227905471,0.09388151505341534,0.01165425704111363,0.8974756421612046,0.0912311780336581,0.011293179805137289,0.8916017680488318,0.09640075773521364,0.011997474215954537
Neuquén,departamento Ñorquín,5572,5014,501,57,2718,2428,266,24,2854,2586,235,33,0.8998564249820531,0.08991385498923188,0.010229720028715004,0.8933038999264165,0.09786607799852833,0.008830022075055188,0.9060967063770147,0.0823405746320953,0.011562718990889979
Neuquén,departamento Pehuenches,29721,16607,11810,1304,14571,8226,5695,650,15150,8381,6115,654,0.5587631640927291,0.3973621345176811,0.043874701389589855,0.5645460160592959,0.39084482876947363,0.04460915517123053,0.5532013201320132,0.4036303630363036,0.043168316831683165
Neuquén,departamento Picún Leufú,5087,4126,819,142,2465,2012,386,67,2622,2114,433,75,0.8110870847257716,0.1609986239433851,0.027914291330843326,0.8162271805273834,0.1565922920892495,0.02718052738336714,0.8062547673531655,0.16514111365369946,0.028604118993135013
Neuquén,departamento Picunches,8471,7212,1108,151,4295,3701,506,88,4176,3511,602,63,0.8513752803683154,0.13079919726124425,0.017825522370440324,0.8616996507566939,0.11781140861466823,0.02048894062863795,0.8407567049808429,0.14415708812260536,0.015086206896551725
Neuquén,departamento Zapala,45540,37234,6789,1517,23377,19138,3419,820,22163,18096,3370,697,0.817610891523935,0.14907773386034257,0.03331137461572244,0.8186679214612653,0.14625486589382727,0.03507721264490739,0.8164959617380319,0.15205522718043585,0.03144881108153228
Río Negro,departamento Adolfo Alsina,63845,45630,16457,1758,32910,23588,8450,872,30935,22042,8007,886,0.7146996632469261,0.25776489936565117,0.027535437387422663,0.7167426314190216,0.2567608629595868,0.026496505621391674,0.7125262647486665,0.25883303701309196,0.028640698238241474
Río Negro,departamento Avellaneda,41160,31823,7090,2247,20812,16194,3486,1132,20348,15629,3604,1115,0.773153547133139,0.17225461613216717,0.05459183673469388,0.7781087833941956,0.16749951950797617,0.05439169709782818,0.7680853155101238,0.17711814428936504,0.054796540200511105
Río Negro,departamento Bariloche,161443,99519,51382,10542,82942,50347,26751,5844,78501,49172,24631,4698,0.6164342833074212,0.3182671283363168,0.06529858835626197,0.6070145402811603,0.32252658484242,0.07045887487641966,0.6263869250073247,0.3137667036088712,0.059846371383804026
Río Negro,departamento Conesa,7398,5575,1339,484,3677,2818,626,233,3721,2757,713,251,0.7535820492024872,0.1809948634766153,0.06542308732089754,0.7663856404677727,0.17024748436225184,0.06336687516997552,0.7409298575651706,0.1916151572158022,0.06745498521902714
Río Negro,departamento El Cuy,6960,3087,3499,374,3259,1444,1625,190,3701,1643,1874,184,0.4435344827586207,0.5027298850574713,0.05373563218390805,0.44308069960110463,0.49861920834611845,0.058300092052776926,0.4439340718724669,0.5063496352337206,0.049716292893812485
Río Negro,departamento General Roca,379627,267674,88793,23160,195220,137095,45693,12432,184407,130579,43100,10728,0.7050973718939907,0.2338953762508989,0.06100725185511041,0.7022589898575966,0.23405901034730048,0.06368199979510296,0.7081021870102545,0.23372214720699322,0.05817566578275228
Río Negro,departamento 9 de Julio,3682,3308,351,23,1781,1597,175,9,1901,1711,176,14,0.8984247691472026,0.0953286257468767,0.0062466051059206955,0.8966872543514879,0.0982594048287479,0.0050533408197641775,0.900052603892688,0.09258285113098369,0.007364544976328248
Río Negro,departamento Ñorquinco,1452,1222,225,5,638,531,104,3,814,691,121,2,0.8415977961432507,0.15495867768595042,0.003443526170798898,0.8322884012539185,0.16300940438871472,0.004702194357366771,0.8488943488943489,0.14864864864864866,0.002457002457002457
Río Negro,departamento Pichi Mahuida,16493,12155,3484,854,8421,6240,1746,435,8072,5915,1738,419,0.7369793245619354,0.21124113260170982,0.05177954283635482,0.7410046312789454,0.20733879586747417,0.051656572853580336,0.7327799801783944,0.21531219028741327,0.05190782953419227
Río Negro,departamento Pilcaniyeu,9309,6323,2660,326,4628,3097,1335,196,4681,3226,1325,130,0.6792351487807499,0.28574497797830056,0.03501987324094962,0.6691875540190146,0.28846153846153844,0.04235090751944685,0.6891689809869685,0.28305917538987396,0.027771843623157447
Río Negro,departamento San Antonio,35473,25127,9533,813,18058,12744,4869,445,17415,12383,4664,368,0.708341555549291,0.26873960476982495,0.022918839680884054,0.7057259940192713,0.269631188392956,0.02464281758777273,0.711053689348263,0.26781510192362906,0.021131208728107954
Río Negro,departamento Valcheta,4300,3924,343,33,2144,1944,180,20,2156,1980,163,13,0.9125581395348837,0.07976744186046511,0.007674418604651163,0.9067164179104478,0.08395522388059702,0.009328358208955223,0.9183673469387755,0.07560296846011132,0.006029684601113173
Río Negro,departamento 25 de Mayo,16555,14226,2122,207,8321,7108,1110,103,8234,7118,1012,104,0.8593174267592872,0.12817879794623982,0.012503775294472969,0.8542242518928014,0.1333974281937267,0.01237831991347194,0.8644644158367744,0.12290502793296089,0.012630556230264756
Salta,departamento Anta,69442,60679,7125,1638,34529,30254,3478,797,34913,30425,3647,841,0.8738083580542035,0.10260361164712999,0.023588030298666515,0.8761910278316777,0.10072692519331576,0.023082046975006515,0.871451894709707,0.10445965686134105,0.024088448428951966
Salta,departamento Cachi,8928,8500,395,33,4478,4255,206,17,4450,4245,189,16,0.9520609318996416,0.044242831541218636,0.003696236559139785,0.9502009825815096,0.04600267976775346,0.003796337650736936,0.9539325842696629,0.042471910112359554,0.0035955056179775282
Salta,departamento Cafayate,17822,15786,1903,133,9180,8142,974,64,8642,7644,929,69,0.8857591740545393,0.10677813937829649,0.007462686567164179,0.8869281045751634,0.10610021786492374,0.006971677559912854,0.8845174728072206,0.10749826429067345,0.007984262902105995
Salta,departamento Capital,624003,530603,78513,14887,326582,276429,41941,8212,297421,254174,36572,6675,0.8503212324299723,0.12582151047350734,0.023857257096520368,0.846430605483462,0.128424101756986,0.025145292759551966,0.8545933205792463,0.12296374499446912,0.022442934426284627
Salta,departamento Cerrillos,55713,49876,4522,1315,28449,25467,2284,698,27264,24409,2238,617,0.8952309155852315,0.08116597562507853,0.02360310878969002,0.8951808499420014,0.08028401701290028,0.024535133045098245,0.8952831572769953,0.0820862676056338,0.02263057511737089
Salta,departamento Chicoana,24715,22952,1608,155,12654,11764,816,74,12061,11188,792,81,0.9286668015375278,0.06506170341897632,0.006271495043495853,0.929666508613877,0.0644855381697487,0.005847953216374269,0.9276179421275185,0.06566619683276677,0.006715861039714784
Salta,departamento General Güemes,55746,46006,8243,1497,28432,23351,4257,824,27314,22655,3986,673,0.8252789437807196,0.1478671115416353,0.02685394467764503,0.8212929093978616,0.1497256612267867,0.028981429375351718,0.8294281320934319,0.14593248883356522,0.024639379073002857
Salta,departamento General José de San Martín,177448,159923,13914,3611,90503,81638,6860,2005,86945,78285,7054,1606,0.9012386727379289,0.07841170371038277,0.020349623551688383,0.9020474459410185,0.07579859231185707,0.022153961747124404,0.9003968025763414,0.08113174995686928,0.01847144746678935
Salta,departamento Guachipas,3491,3317,159,15,1744,1661,77,6,1747,1656,82,9,0.9501575479805213,0.045545688914351186,0.00429676310512747,0.9524082568807339,0.04415137614678899,0.0034403669724770644,0.9479107040641099,0.04693760732684602,0.005151688609044075
Salta,departamento Iruya,6116,5090,919,107,3176,2603,515,58,2940,2487,404,49,0.8322432962720733,0.15026160889470241,0.01749509483322433,0.8195843828715366,0.1621536523929471,0.018261964735516372,0.8459183673469388,0.13741496598639455,0.016666666666666666
Salta,departamento La Caldera,12246,10196,1810,240,6098,5057,918,123,6148,5139,892,117,0.8325983994773803,0.14780336436387392,0.019598236158745713,0.8292882912430305,0.15054116103640539,0.02017054772056412,0.8358815875081327,0.14508783344176968,0.01903057905009759
Salta,departamento La Candelaria,7182,5371,1786,25,3559,2666,884,9,3623,2705,902,16,0.7478418267891952,0.24867724867724866,0.0034809245335561123,0.7490868221410508,0.2483843776341669,0.002528800224782242,0.7466188241788573,0.24896494617720122,0.004416229643941485
Salta,departamento La Poma,1789,1658,130,1,939,870,69,0,850,788,61,1,0.9267747344885411,0.07266629401900503,0.0005589714924538849,0.9265175718849841,0.07348242811501597,0.0,0.9270588235294117,0.07176470588235294,0.001176470588235294
Salta,departamento La Viña,8888,8132,689,67,4524,4148,341,35,4364,3984,348,32,0.914941494149415,0.07752025202520252,0.007538253825382538,0.9168877099911583,0.07537577365163572,0.007736516357206013,0.9129239230064161,0.07974335472043996,0.007332722273143905
Salta,departamento Los Andes,7182,6506,665,11,3645,3300,339,6,3537,3206,326,5,0.9058758006126427,0.09259259259259259,0.0015316067947646894,0.9053497942386831,0.09300411522633745,0.0016460905349794238,0.9064178682499293,0.09216850438224485,0.0014136273678258412
Salta,departamento Metán,48028,41761,5932,335,24392,21233,2995,164,23636,20528,2937,171,0.8695136170567169,0.12351128508370117,0.00697509785958191,0.8704903246966218,0.12278615939652344,0.006723515906854706,0.8685056693179896,0.1242596039939076,0.007234726688102894
Salta,departamento Molinos,5808,5659,139,10,2955,2873,73,9,2853,2786,66,1,0.9743457300275482,0.02393250688705234,0.001721763085399449,0.9722504230118443,0.024703891708967852,0.003045685279187817,0.9765159481247809,0.023133543638275498,0.0003505082369435682
Salta,departamento Orán,159715,140452,15127,4136,80789,71062,7480,2247,78926,69390,7647,1889,0.8793914159596782,0.09471245656325329,0.02589612747706853,0.8795999455371399,0.09258686207280695,0.0278131923900531,0.8791779641689684,0.09688822441274104,0.02393381141829055
Salta,departamento Rivadavia,38062,36492,1439,131,18887,18028,782,77,19175,18464,657,54,0.9587515106930797,0.03780673637748936,0.0034417529294309287,0.9545189813098957,0.041404140414041404,0.004076878276062901,0.9629204693611473,0.03426336375488918,0.002816166883963494
Salta,departamento Rosario de la Frontera,33750,30256,3323,171,17249,15397,1769,83,16501,14859,1554,88,0.8964740740740741,0.09845925925925926,0.005066666666666666,0.892631456896052,0.10255666995188127,0.004811873152066787,0.900490879340646,0.09417611053875523,0.0053330101205987515
Salta,departamento Rosario de Lerma,50961,45556,4708,697,25930,23218,2347,365,25031,22338,2361,332,0.8939385019917192,0.09238437236317969,0.013677125645101157,0.8954107211723872,0.09051291939838026,0.014076359429232549,0.8924134073748552,0.09432303943110543,0.013263553194039391
Salta,departamento San Carlos,7779,7298,462,19,3898,3624,262,12,3881,3674,200,7,0.9381668594935082,0.059390667180871576,0.0024424733256202596,0.9297075423293997,0.0672139558748076,0.0030785017957927143,0.9466632311259985,0.0515331100231899,0.0018036588508116465
Salta,departamento Santa Victoria,9411,8160,988,263,4791,4140,517,134,4620,4020,471,129,0.8670704494740198,0.10498352991180533,0.0279460206141749,0.8641202254226675,0.1079106658317679,0.0279691087455646,0.8701298701298701,0.10194805194805195,0.02792207792207792
San Juan,departamento Albardón,31281,29177,1953,151,15799,14783,953,63,15482,14394,1000,88,0.9327387231865989,0.06243406540711614,0.004827211406284965,0.9356921324134438,0.060320273435027535,0.003987594151528578,0.9297248417517117,0.06459113809585325,0.005684020152435086
San Juan,departamento Angaco,10172,9732,394,46,5070,4849,197,24,5102,4883,197,22,0.9567440031458907,0.03873377900117971,0.004522217852929611,0.9564102564102565,0.0388560157790927,0.004733727810650888,0.9570756566052528,0.038612308898471184,0.00431203449627597
San Juan,departamento Calingasta,10667,9327,1245,95,5215,4565,602,48,5452,4762,643,47,0.8743789256585732,0.1167151026530421,0.008905971688384738,0.87535953978907,0.11543624161073826,0.009204218600191754,0.8734409391049156,0.11793837123991197,0.008620689655172414
San Juan,departamento Capital,114849,99655,12949,2245,60992,52941,6879,1172,53857,46714,6070,1073,0.867704551193306,0.11274804308265636,0.01954740572403765,0.8679990818467995,0.1127852833158447,0.01921563483735572,0.8673710009840875,0.11270586924633752,0.019923129769574985
San Juan,departamento Caucete,44017,41013,2852,152,22488,20911,1497,80,21529,20102,1355,72,0.9317536406388441,0.06479314810186973,0.003453211259286185,0.9298737104233369,0.06656883671291355,0.0035574528637495554,0.9337173115332806,0.0629383622091133,0.0033443262576060197
San Juan,departamento Chimbas,103772,94537,8648,587,53143,48293,4539,311,50629,46244,4109,276,0.911006822649655,0.08333654550360406,0.005656631846740932,0.9087368044709557,0.08541106072295504,0.005852134806089231,0.9133895593434593,0.08115901953425902,0.005451421122281697
San Juan,departamento Iglesia,8826,8174,604,48,4381,4042,317,22,4445,4132,287,26,0.9261273510083843,0.06843417176523907,0.005438477226376614,0.9226204062999315,0.07235790915316138,0.005021684546907099,0.9295838020247469,0.06456692913385827,0.005849268841394826
San Juan,departamento Jáchal,25269,23441,1709,119,12812,11874,887,51,12457,11567,822,68,0.9276583956626697,0.06763227670267917,0.004709327634651154,0.9267873868248517,0.06923197002809865,0.0039806431470496405,0.9285542265392952,0.06598699526370715,0.005458778196997672
San Juan,departamento 9 de Julio,12498,11422,948,128,6286,5736,487,63,6212,5686,461,65,0.9139062249959994,0.07585213634181469,0.01024163866218595,0.9125039770919504,0.07747375119312759,0.01002227171492205,0.9153251770766259,0.07421120412105602,0.010463618802318095
San Juan,departamento Pocito,72879,66685,5315,879,37065,33912,2724,429,35814,32773,2591,450,0.9150098107822555,0.07292910166165836,0.012061087556086115,0.9149332254148118,0.07349251315256981,0.011574261432618372,0.9150890713128944,0.07234600994024683,0.01256491874685877
San Juan,departamento Rawson,136582,125413,9980,1189,70395,64539,5248,608,66187,60874,4732,581,0.9182249491148174,0.07306965778799548,0.008705393097187038,0.9168122735989772,0.0745507493429931,0.00863697705802969,0.9197274389230513,0.07149440222400169,0.008778158852946954
San Juan,departamento Rivadavia,101334,88296,11803,1235,52802,45960,6195,647,48532,42336,5608,588,0.8713363727870211,0.11647620739337242,0.01218741981960645,0.8704215749403432,0.11732510132191963,0.012253323737737206,0.8723316574631171,0.11555262507211736,0.012115717464765516
San Juan,departamento San Martín,15037,13987,914,136,7554,7066,430,58,7483,6921,484,78,0.9301722418035513,0.060783400944337304,0.009044357252111458,0.9353984643897273,0.05692348424675669,0.007678051363516018,0.9248964319123346,0.06467994120005345,0.01042362688761192
San Juan,departamento Santa Lucía,62697,54291,7620,786,32344,27952,4004,388,30353,26339,3616,398,0.865926599358821,0.12153691564189674,0.012536484999282262,0.8642097452386841,0.12379421221864952,0.011996042542666337,0.867756070240174,0.11913155207063553,0.013112377689190526
San Juan,departamento Sarmiento,27188,24908,1952,328,13417,12352,904,161,13771,12556,1048,167,0.9161394732970428,0.07179638075621597,0.01206414594674121,0.9206230901095624,0.06737720801967653,0.011999701870760975,0.9117711132089172,0.07610195338029192,0.012126933410790791
San Juan,departamento Ullum,6454,6050,379,25,3185,2986,188,11,3269,3064,191,14,0.9374031608304927,0.05872327238921599,0.0038735667802912922,0.9375196232339089,0.05902668759811617,0.003453689167974882,0.9372896910370144,0.05842765371673295,0.004282655246252677
San Juan,departamento Valle Fértil,8425,7527,855,43,4229,3756,454,19,4196,3771,401,24,0.8934124629080119,0.10148367952522255,0.005103857566765579,0.8881532277134074,0.10735398439347363,0.004492787893118941,0.8987130600571973,0.0955672068636797,0.005719733079122974
San Juan,departamento 25 de Mayo,20824,19572,1212,40,10342,9691,629,22,10482,9881,583,18,0.9398770649250865,0.058202074529389164,0.001920860545524395,0.9370527944304776,0.06081995745503771,0.0021272481144846258,0.9426636138141576,0.05561915664949437,0.0017172295363480253
San Juan,departamento Zonda,6674,6005,641,28,3325,2969,338,18,3349,3036,303,10,0.8997602637099191,0.09604435121366497,0.004195385076415942,0.8929323308270677,0.10165413533834586,0.005413533834586466,0.9065392654523738,0.0904747685876381,0.002985965959988056
San Luis,departamento Ayacucho,23653,17534,5903,216,11923,8828,2970,125,11730,8706,2933,91,0.741301314843783,0.24956665116475713,0.009132033991459856,0.7404176801140653,0.24909838127987924,0.010483938606055523,0.7421994884910486,0.25004262574595054,0.0077578857630008526
San Luis,departamento Belgrano,5575,4114,1377,84,2664,1924,691,49,2911,2190,686,35,0.7379372197309417,0.24699551569506725,0.015067264573991032,0.7222222222222222,0.2593843843843844,0.01839339339339339,0.7523187907935417,0.23565784953624183,0.01202335967021642
San Luis,departamento Chacabuco,26522,18319,7900,303,13363,9196,4020,147,13159,9123,3880,156,0.690709599577709,0.29786592263026923,0.011424477792021718,0.6881688243657861,0.30083065179974555,0.011000523834468309,0.6932897636598526,0.2948552321604985,0.01185500417964891
San Luis,departamento Coronel Pringles,16044,12749,3157,138,7909,6250,1585,74,8135,6499,1572,64,0.7946272749937672,0.1967713787085515,0.008601346297681375,0.7902389682640031,0.20040460235175117,0.009356429384245796,0.7988936693300553,0.19323909035033804,0.007867240319606637
San Luis,departamento General Pedernera,148671,113083,34242,1346,76084,57783,17593,708,72587,55300,16649,638,0.7606258113552744,0.2303206408781807,0.009053547766544922,0.7594632248567373,0.23123127070080438,0.009305504442458335,0.7618444074007742,0.22936613994241392,0.008789452656811825
San Luis,departamento Gobernador Dupuy,14334,9840,4043,451,6960,4791,1955,214,7374,5049,2088,237,0.6864796986186689,0.28205664852797546,0.03146365285335566,0.6883620689655172,0.28089080459770116,0.03074712643678161,0.6847030105777054,0.28315703824247357,0.03213995117982099
San Luis,departamento Juan Martín de Pueyrredón,260769,184786,71079,4904,134484,94822,37078,2584,126285,89964,34001,2320,0.7086195061529553,0.2725745774996261,0.018805916347418596,0.7050801582344368,0.2757056601528806,0.01921418161268255,0.7123886447321535,0.2692402106346755,0.018371144633171
San Luis,departamento Junín,40289,18509,21016,764,20654,9345,10902,407,19635,9164,10114,357,0.4594057931445308,0.5216312144754152,0.018962992380054108,0.45245473031858235,0.5278396436525612,0.019705626028856397,0.4667175961293608,0.515100585688821,0.01818181818181818
San Luis,departamento Libertador General San Martín,4691,4171,507,13,2201,1966,230,5,2490,2205,277,8,0.8891494350884673,0.1080793007887444,0.002771264122788318,0.8932303498409814,0.10449795547478419,0.002271694684234439,0.8855421686746988,0.11124497991967872,0.00321285140562249
Santa Cruz,departamento Corpen Aike,15035,7162,7257,616,7635,3720,3540,375,7400,3442,3717,241,0.4763551712670436,0.4826737612238111,0.04097106750914533,0.48722986247544203,0.4636542239685658,0.04911591355599214,0.46513513513513516,0.5022972972972973,0.03256756756756757
Santa Cruz,departamento Deseado,126266,69767,48972,7527,63539,35046,24271,4222,62727,34721,24701,3305,0.5525398761345097,0.3878478767047345,0.05961224716075587,0.5515667542769008,0.3819858669478588,0.0664473787752404,0.553525595038819,0.3937857700830583,0.052688634878122656
Santa Cruz,departamento Güer Aike,137309,79319,47468,10522,70006,40253,23648,6105,67303,39066,23820,4417,0.5776678877568113,0.3457020297285684,0.0766300825146203,0.5749935719795446,0.33779961717567064,0.08720681084478474,0.5804496084869917,0.3539218162637624,0.06562857524924595
Santa Cruz,departamento Lago Argentino,25384,9644,14324,1416,12789,4751,7274,764,12595,4893,7050,652,0.3799243618027104,0.5642924676961866,0.055783170501103055,0.3714911251857065,0.5687700367503323,0.059738838063961214,0.3884874950377134,0.5597459309249703,0.051766574037316396
Santa Cruz,departamento Lago Buenos Aires,12584,6428,5213,943,6246,3232,2502,512,6338,3196,2711,431,0.510807374443738,0.4142561983471074,0.07493642720915449,0.5174511687479987,0.40057636887608067,0.08197246237592058,0.5042600189334174,0.4277374566109183,0.06800252445566425
Santa Cruz,departamento Magallanes,12828,6747,5415,666,6411,3458,2593,360,6417,3289,2822,306,0.5259588400374181,0.42212347988774557,0.0519176800748363,0.5393854312899704,0.4044610825144283,0.05615348619560131,0.5125448028673835,0.4397693626305127,0.047685834502103785
Santa Cruz,departamento Río Chico,6271,3575,2275,421,3186,1808,1168,210,3085,1767,1107,211,0.5700845160261522,0.3627810556530059,0.06713442832084197,0.5674827369742624,0.36660389202762084,0.06591337099811675,0.572771474878444,0.35883306320907615,0.06839546191247974
Santa Fe,departamento Belgrano,48544,41096,6919,529,24506,20781,3456,269,24038,20315,3463,260,0.8465721819380356,0.14253048780487804,0.010897330257086354,0.8479964090426835,0.14102668734187546,0.010976903615441116,0.8451202263083452,0.1440635660204676,0.010816207671187288
Santa Fe,departamento Caseros,86261,73035,12622,604,44348,37302,6725,321,41913,35733,5897,283,0.8466746270040922,0.1463233674545855,0.007002005541322266,0.8411202309010553,0.1516415621899522,0.007238206908992514,0.8525517142652638,0.14069620404170544,0.006752081693030802
Santa Fe,departamento Castellanos,189464,158447,29993,1024,96738,80779,15449,510,92726,77668,14544,514,0.8362907993075201,0.1583044800067559,0.005404720685723937,0.8350286340424652,0.15969939424011248,0.005271971717422316,0.8376075750059314,0.15684921165584625,0.0055432133382222895
Santa Fe,departamento Constitución,93000,76680,15483,837,47761,39245,8074,442,45239,37435,7409,395,0.824516129032258,0.16648387096774195,0.009,0.8216955256380729,0.16905006176587592,0.009254412596051172,0.8274939764362608,0.16377461924445721,0.008731404319282035
Santa Fe,departamento Garay,24853,22796,1843,214,12576,11538,936,102,12277,11258,907,112,0.9172333319921137,0.07415603750050295,0.008610630507383414,0.9174618320610687,0.07442748091603053,0.008110687022900763,0.9169992669218865,0.07387798322065652,0.009122749857457034
Santa Fe,departamento General López,200455,165777,32812,1866,102782,84517,17264,1001,97673,81260,15548,865,0.8270035668853358,0.16368761068569004,0.009308822428974083,0.8222937868498376,0.16796715378179058,0.009739059368371893,0.8319597022718663,0.15918421672314764,0.008856081004986026
Santa Fe,departamento General Obligado,197533,180943,15548,1042,101343,92810,7979,554,96190,88133,7569,488,0.9160140330982671,0.07871089893840523,0.005275067963327646,0.9158007953188676,0.0787326209012956,0.005466583779836792,0.9162386942509616,0.07868801330699657,0.005073292442041792
Santa Fe,departamento Iriondo,73636,64569,8560,507,37801,33052,4500,249,35835,31517,4060,258,0.8768672931718181,0.11624748764191428,0.006885219186267586,0.8743684029523029,0.1190444697230232,0.006587127324673951,0.8795032789172597,0.113297055950886,0.007199665131854332
Santa Fe,departamento La Capital,568259,506872,55798,5589,298349,264688,30710,2951,269910,242184,25088,2638,0.8919735543123822,0.09819114171530939,0.009835303972308402,0.8871757572507366,0.10293314205846174,0.009891100690801713,0.8972768700678003,0.0929495016857471,0.009773628246452521
Santa Fe,departamento Las Colonias,114730,103306,10738,686,58352,52535,5470,347,56378,50771,5268,339,0.9004270896888347,0.09359365466748017,0.005979255643685174,0.9003119001919386,0.09374143131340829,0.005946668494653139,0.9005463123913583,0.09344070382063925,0.006012983788002412
Santa Fe,departamento 9 de Julio,30942,27221,3652,69,15665,13730,1899,36,15277,13491,1753,33,0.8797427444896904,0.11802727684054036,0.002229978669769246,0.8764762208745611,0.12122566230450048,0.0022981168209383978,0.8830922301498986,0.11474765988086666,0.0021601099692347974
Santa Fe,departamento Rosario,1337958,1115199,190263,32496,700609,579247,103990,17372,637349,535952,86273,15124,0.8335082267156368,0.14220401537267985,0.024287757911683326,0.8267764188013571,0.1484280104880183,0.024795570710624614,0.8409081994323361,0.1353622583545279,0.023729542213135973
Santa Fe,departamento San Cristóbal,72593,60918,11390,285,36834,30878,5830,126,35759,30040,5560,159,0.8391718209744741,0.15690218065102696,0.003925998374498919,0.8383015692023674,0.1582776782320682,0.0034207525655644243,0.840068234570318,0.15548533236388043,0.004446433065801616
Santa Fe,departamento San Javier,33180,31069,2016,95,16850,15732,1074,44,16330,15337,942,51,0.9363773357444244,0.060759493670886074,0.002863170584689572,0.9336498516320475,0.06373887240356083,0.002611275964391691,0.9391916717697489,0.057685241886099206,0.0031230863441518678
Santa Fe,departamento San Jerónimo,84617,74635,9506,476,43385,38292,4844,249,41232,36343,4662,227,0.8820331611851047,0.1123414916624319,0.005625347152463453,0.8826091967269794,0.11165149245130805,0.005739310821712573,0.8814270469538222,0.1130675203725262,0.005505432673651533
Santa Fe,departamento San Justo,46486,42688,3627,171,23836,21884,1866,86,22650,20804,1761,85,0.9182979821881857,0.07802349094350987,0.003678526868304436,0.9181070649437825,0.07828494713878167,0.0036079879174358113,0.9184988962472406,0.07774834437086092,0.0037527593818984547
Santa Fe,departamento San Lorenzo,193786,169008,23001,1777,99399,86413,12027,959,94387,82595,10974,818,0.8721373061005439,0.11869278482449712,0.009169909074958975,0.8693548224831236,0.1209971931307156,0.009647984386160827,0.8750675410808691,0.11626601120917075,0.008666447709960058
Santa Fe,departamento San Martín,67299,58435,8447,417,34298,29690,4391,217,33001,28745,4056,200,0.8682892762150998,0.12551449501478476,0.006196228770115455,0.8656481427488484,0.1280249577234824,0.006326899527669252,0.8710342110845126,0.12290536650404534,0.006060422411442078
Santa Fe,departamento Vera,55463,51521,3764,178,28353,26334,1930,89,27110,25187,1834,89,0.928925590032995,0.06786506319528335,0.0032093467717216884,0.928790604168871,0.06807039819419462,0.003138997636934363,0.9290667650313538,0.06765031353744005,0.003282921431206197
Santiago del Estero,departamento Aguirre,8959,7412,1496,51,4497,3716,749,32,4462,3696,747,19,0.8273244781783681,0.16698292220113853,0.0056925996204933585,0.8263286635534801,0.16655548143206583,0.00711585501445408,0.8283281039892425,0.1674137158225011,0.004258180188256387
Santiago del Estero,departamento Alberdi,20104,18040,1962,102,9799,8804,946,49,10305,9236,1016,53,0.8973338639076801,0.0975925189017111,0.005073617190608834,0.8984590264312685,0.09654046331258291,0.005000510256148586,0.8962639495390587,0.09859291606016497,0.0051431344007763224
Santiago del Estero,departamento Atamisqui,14894,13601,1218,75,7388,6736,609,43,7506,6865,609,32,0.9131865180609642,0.08177789713978784,0.005035584799248019,0.9117487818083378,0.08243096913914456,0.005820249052517596,0.9146016520117239,0.08113509192645883,0.004263256061817213
Santiago del Estero,departamento Avellaneda,25462,23404,1946,112,12643,11617,964,62,12819,11787,982,50,0.9191736705679051,0.0764276176262666,0.0043987118058282934,0.9188483745946373,0.07624772601439532,0.004903899390967334,0.9194945003510414,0.07660503939464856,0.0039004602543100085
Santiago del Estero,departamento Banda,170401,155445,14262,694,87892,80277,7270,345,82509,75168,6992,349,0.9122305620272182,0.08369669192082206,0.004072746051959789,0.9133595776634961,0.08271515041186911,0.0039252719246347795,0.9110278878667781,0.08474227054018349,0.004229841593038335
Santiago del Estero,departamento Belgrano,10809,8122,2565,122,5329,4092,1187,50,5480,4030,1378,72,0.7514108613192709,0.2373022481265612,0.011286890554167824,0.7678738975417527,0.22274347907674985,0.009382623381497467,0.7354014598540146,0.2514598540145985,0.013138686131386862
Santiago del Estero,departamento Capital,328824,295578,31058,2188,172195,154881,16234,1080,156629,140697,14824,1108,0.8988942412962557,0.09445174318176289,0.006654015521981364,0.8994512035773397,0.094276837306542,0.006271959116118354,0.8982819273570029,0.09464403143734558,0.007074041205651572
Santiago del Estero,departamento Choya,43692,37104,6370,218,22048,18648,3287,113,21644,18456,3083,105,0.8492172480087888,0.14579328023436786,0.0049894717568433585,0.8457910014513788,0.14908381712626995,0.005125181422351233,0.8527074477915357,0.14244132323045647,0.0048512289780077615
Santiago del Estero,departamento Copo,35653,29634,5863,156,17503,14473,2957,73,18150,15161,2906,83,0.8311783019661739,0.16444618966145907,0.004375508372366982,0.8268868194023882,0.16894246700565618,0.0041707135919556645,0.8353168044077135,0.16011019283746555,0.004573002754820936
Santiago del Estero,departamento Figueroa,20246,18701,1527,18,9859,9112,737,10,10387,9589,790,8,0.9236886298528104,0.07542230564062037,0.0008890645065691989,0.9242316664976163,0.07475403184907191,0.001014301653311695,0.923173197265813,0.0760566092230673,0.0007701935111196688
Santiago del Estero,departamento General Taboada,46304,42092,3979,233,23370,21306,1948,116,22934,20786,2031,117,0.9090359364201797,0.08593210089841051,0.005031962681409813,0.9116816431322208,0.08335472828412495,0.004963628583654257,0.9063399319787215,0.08855847213743787,0.005101595883840586
Santiago del Estero,departamento Guasayán,9251,7351,1859,41,4549,3596,930,23,4702,3755,929,18,0.7946167981839801,0.20095124851367419,0.0044319533023456925,0.790503407342273,0.20444053638162232,0.005056056276104638,0.7985963419821352,0.19757549978732455,0.0038281582305401958
Santiago del Estero,departamento Jiménez,18622,12501,5945,176,9281,6239,2960,82,9341,6262,2985,94,0.6713027601761358,0.3192460530555257,0.009451186768338525,0.6722335955177244,0.31893114966059694,0.008835254821678698,0.6703779038646825,0.31955893373300504,0.010063162402312387
Santiago del Estero,departamento Juan Felipe Ibarra,20567,19006,1497,64,10229,9458,741,30,10338,9548,756,34,0.9241017163417125,0.07278650264987602,0.003111781008411533,0.9246260631537785,0.07244109883664092,0.002932838009580604,0.9235828980460438,0.07312826465467208,0.0032888372992841944
Santiago del Estero,departamento Loreto,24047,22000,1940,107,12094,11029,1015,50,11953,10971,925,57,0.9148750363870753,0.08067534411776937,0.0044496194951553205,0.911939804861915,0.08392591367620307,0.004134281461881925,0.9178448924956077,0.07738643018489082,0.00476867731950138
Santiago del Estero,departamento Mitre,1440,1240,199,1,670,577,93,0,770,663,106,1,0.8611111111111112,0.13819444444444445,0.0006944444444444445,0.8611940298507462,0.13880597014925372,0.0,0.861038961038961,0.13766233766233765,0.0012987012987012987
Santiago del Estero,departamento Moreno,40352,36036,4243,73,19884,17816,2039,29,20468,18220,2204,44,0.8930412371134021,0.10514968279143537,0.0018090800951625695,0.895996781331724,0.10254475960571313,0.0014584590625628647,0.8901700214969709,0.10768028141489154,0.0021496970881375805
Santiago del Estero,departamento Ojo de Agua,15008,11803,3177,28,7555,5952,1591,12,7453,5851,1586,16,0.7864472281449894,0.21168710021321963,0.0018656716417910447,0.7878226340172072,0.21058901389808074,0.0015883520847121111,0.7850529987924326,0.2128002146786529,0.002146786528914531
Santiago del Estero,departamento Pellegrini,26193,19544,6556,93,12759,9394,3320,45,13434,10150,3236,48,0.7461535524758524,0.2502958805787806,0.003550566945367083,0.7362645975389921,0.26020848028842386,0.003526922172584058,0.755545630489802,0.24088134583891618,0.003573023671281822
Santiago del Estero,departamento Quebrachos,12336,9136,3052,148,6264,4652,1533,79,6072,4484,1519,69,0.7405966277561609,0.24740596627756162,0.011997405966277562,0.7426564495530013,0.24473180076628354,0.012611749680715198,0.738471673254282,0.25016469038208167,0.011363636363636364
Santiago del Estero,departamento Río Hondo,66637,54646,11805,186,33725,27478,6154,93,32912,27168,5651,93,0.8200549244413764,0.17715383345588787,0.0027912421027357173,0.8147664936990363,0.1824759080800593,0.0027575982209043738,0.8254739912493924,0.1717002916869227,0.002825717063684978
Santiago del Estero,departamento Rivadavia,5314,2530,2775,9,2627,1219,1403,5,2687,1311,1372,4,0.4761008656379375,0.5222054949190816,0.0016936394429808055,0.4640274076893795,0.5340692805481538,0.001903311762466692,0.4879047264607369,0.5106066244882769,0.00148864905098623
Santiago del Estero,departamento Robles,53879,48361,5231,287,27405,24626,2642,137,26474,23735,2589,150,0.8975853300915013,0.09708791922641474,0.005326750682083929,0.8985951468710089,0.0964057653712826,0.004999087757708447,0.8965400015109164,0.09779406209866284,0.00566593639042079
Santiago del Estero,departamento Salavina,12775,11762,995,18,6170,5650,511,9,6605,6112,484,9,0.9207045009784736,0.07788649706457926,0.0014090019569471624,0.9157212317666127,0.08282009724473258,0.001458670988654781,0.9253595760787282,0.0732778198334595,0.0013626040878122634
Santiago del Estero,departamento San Martín,11183,10329,802,52,5556,5134,396,26,5627,5195,406,26,0.9236340874541715,0.07171599749619958,0.004649915049628901,0.9240460763138949,0.07127429805615551,0.004679625629949604,0.9232272969610805,0.07215212368935489,0.004620579349564599
Santiago del Estero,departamento Sarmiento,5034,4735,281,18,2473,2306,155,12,2561,2429,126,6,0.9406038935240365,0.05582042113627334,0.003575685339690107,0.9324706833805095,0.06267691063485645,0.004852405984634048,0.9484576337368216,0.049199531433033974,0.0023428348301444747
Santiago del Estero,departamento Silípica,9766,9257,499,10,4830,4602,226,2,4936,4655,273,8,0.9478804013925866,0.05109563792750359,0.0010239606799098914,0.9527950310559006,0.04679089026915114,0.00041407867494824016,0.9430713128038898,0.055307941653160456,0.0016207455429497568
Tierra del Fuego,departamento Río Grande,98922,43481,48693,6748,49667,21723,24170,3774,49255,21758,24523,2974,0.4395483310082691,0.4922363073937041,0.06821536159802673,0.43737290353756014,0.4866410292548372,0.07598606720760263,0.44174195513145875,0.49787838798091566,0.06037965688762562
Tierra del Fuego,departamento Tolhuin,6027,2317,3290,420,2999,1137,1647,215,3028,1180,1643,205,0.38443670150987225,0.5458768873403019,0.06968641114982578,0.37912637545848615,0.5491830610203401,0.07169056352117373,0.38969616908850724,0.5426023778071334,0.06770145310435931
Tierra del Fuego,departamento Ushuaia,80009,32712,42214,5083,40550,16441,21420,2689,39459,16271,20794,2394,0.4088540039245585,0.5276156432401354,0.06353035283530603,0.40545006165228115,0.5282367447595561,0.06631319358816276,0.4123520616335944,0.5269773689145696,0.06067056945183608
Tucumán,departamento Burruyacú,45459,39960,5307,192,22563,19820,2661,82,22896,20140,2646,110,0.8790338546822412,0.11674255922919553,0.00422358608856332,0.8784292868856092,0.11793644462172584,0.0036342684926649826,0.8796296296296297,0.11556603773584906,0.004804332634521314
Tucumán,departamento Capital,587289,510047,71811,5431,309579,267604,39204,2771,277710,242443,32607,2660,0.8684770189804338,0.12227540444312766,0.009247576576438517,0.86441263780812,0.12663649666159527,0.008950865530284676,0.8730078139065932,0.11741384897915091,0.009578337114255878
Tucumán,departamento Chicligasta,92308,84328,7526,454,47608,43390,3988,230,44700,40938,3538,224,0.9135502881657062,0.08153139489535034,0.0049183169389435365,0.9114014451352714,0.08376743404469837,0.004831120820030247,0.9158389261744967,0.07914988814317674,0.005011185682326622
Tucumán,departamento Cruz Alta,227688,207123,19743,822,116110,105113,10590,407,111578,102010,9153,415,0.9096790344682196,0.0867107620954991,0.003610203436281227,0.9052880888812334,0.09120661441736284,0.003505296701403841,0.9142483285235441,0.08203230027424761,0.003719371202208321
Tucumán,departamento Famaillá,42669,38008,4521,140,21615,19210,2335,70,21054,18798,2186,70,0.8907637863554337,0.10595514307811292,0.0032810705664533973,0.888734674994217,0.10802683321767291,0.003238491788110109,0.8928469649472784,0.10382825116367436,0.003324783889047212
Tucumán,departamento Graneros,15539,13851,1618,70,7678,6884,763,31,7861,6967,855,39,0.8913701010361027,0.10412510457558402,0.004504794388313276,0.8965876530346445,0.09937483719718676,0.004037509768168794,0.886274010940084,0.10876478819488615,0.004961200865029895
Tucumán,departamento Juan Bautista Alberdi,34745,31917,2660,168,17634,16172,1374,88,17111,15745,1286,80,0.9186069938120592,0.076557778097568,0.004835228090372716,0.917091981399569,0.0779176590677101,0.00499035953272088,0.9201683127812518,0.07515633218397522,0.004675355034772953
Tucumán,departamento La Cocha,21196,18540,2571,85,10717,9371,1310,36,10479,9169,1261,49,0.8746933383657294,0.12129647103227024,0.004010190602000378,0.8744051506951572,0.12223570028926005,0.0033591490155827192,0.874988071380857,0.12033590991506823,0.004676018704074816
Tucumán,departamento Leales,66352,59567,6536,249,33326,29855,3356,115,33026,29712,3180,134,0.8977423438630335,0.09850494333252954,0.0037527128044369425,0.895847086358999,0.10070215447398427,0.0034507591670167436,0.8996548174165808,0.09628777326954521,0.004057409313873918
Tucumán,departamento Lules,93464,83359,9176,929,47658,42397,4782,479,45806,40962,4394,450,0.8918835059488145,0.09817683814088847,0.009939655910297013,0.889609299592933,0.10033992194384993,0.010050778463217088,0.8942496616163821,0.09592629786490853,0.009824040518709339
Tucumán,departamento Monteros,77469,71692,5512,265,39593,36575,2888,130,37876,35117,2624,135,0.9254282358104532,0.07115104106158593,0.0034207231279608616,0.9237744045664638,0.07294218675018312,0.003283408683353118,0.9271570387580526,0.06927869891223994,0.0035642623297074665
Tucumán,departamento Río Chico,64927,60038,4587,302,33050,30508,2406,136,31877,29530,2181,166,0.9247000477459301,0.07064857455295948,0.004651377701110478,0.9230862329803329,0.07279878971255674,0.004114977307110438,0.9263732471688051,0.0684192364400665,0.0052075163911284
Tucumán,departamento Simoca,36946,32606,4177,163,18465,16231,2144,90,18481,16375,2033,73,0.8825312618416067,0.11305689384507119,0.004411844313322146,0.879014351475765,0.11611156241538045,0.00487408610885459,0.8860451274281694,0.11000486986634922,0.0039500027054813055
Tucumán,departamento Tafí del Valle,22382,16769,5444,169,11300,8410,2804,86,11082,8359,2640,83,0.7492181217049415,0.24323116790277902,0.0075507103922795105,0.7442477876106195,0.24814159292035398,0.007610619469026548,0.7542862299223967,0.2382241472658365,0.007489622811766829
Tucumán,departamento Tafí Viejo,172877,155029,16720,1128,88985,79523,8890,572,83892,75506,7830,556,0.8967589673582952,0.09671616235820844,0.006524870283496359,0.8936674720458504,0.09990447828285666,0.006428049671292914,0.9000381442807419,0.09333428694035188,0.0066275687789062124
Tucumán,departamento Trancas,23438,19775,2867,796,11702,9830,1470,402,11736,9945,1397,394,0.8437153340728731,0.12232272378189266,0.033961942145234236,0.8400273457528628,0.12561955221329688,0.03435310203384037,0.8473926380368099,0.11903544648943422,0.033571915473755966
Tucumán,departamento Yerba Buena,102589,89117,12510,962,53054,45801,6774,479,49535,43316,5736,483,0.8686798779596253,0.12194289836142276,0.009377223678951935,0.8632902325932069,0.12768123044445281,0.009028536962340256,0.8744524073887151,0.11579691127485617,0.009750681336428788
